##########
##########
##########
##########
### ######
###  #####
#  $.    #
## $. $. #
#@$ .##  #
##########