##########
#. #######
# ########
#  #######
# $#######
#  ## @###
# . $ ####
# .$# ####
#  $ .####
##########