##########
# @  #####
#$$#######
# .##  ###
#..      #
#    $$.##
######   #
#######  #
##       #
##########