##########
###    . #
#### . $.#
#####  ###
#####. $ #
######   #
###### $ #
####   $ #
####@  # #
##########