##########
#     . .#
# $.  #$ #
##  #.   #
### #$ ###
#####  ###
###### ###
# # # $###
# @    ###
##########