##########
### # .  #
### .. . #
###   $ ##
#####$ ###
#####   ##
######$###
##### $  #
#####  @ #
##########