##########
#  #######
#.$#######
# .#######
#. #######
#  #######
# .$@#####
#$$ ######
#   ######
##########