##########
##  ######
#. #######
#  $. ####
# .  #####
# . ######
#$$$######
#   ######
#@########
##########