##########
# .  @ ###
#     $  #
## .  .$.#
##### #  #
##### #$ #
#######  #
#######$ #
######   #
##########