##########
######.  #
######   #
#######  #
##  ##  ##
## $@##$ #
## $##  ##
#.   # $ #
#   ..   #
##########