##########
# $ .#####
# $ ######
# ########
#.########
#.########
#  ##   ##
#. $@$ ###
#        #
##########