##########
##########
##########
##########
###### ###
###### ###
##      ##
##.$.$.$ #
## $ @  .#
##########