##########
#######@ #
######.  #
######   #
######   #
###  .   #
# #$ #   #
#  $$##$ #
#.  .    #
##########