##########
#@########
#$########
#  #######
# # ######
#.   #####
#.$$$#####
#  #. ####
#.    ####
##########