##########
#     ####
## $$#####
##@$    ##
# ## .   #
# .    . #
# $ ###  #
#  ##### #
#.       #
##########