##########
#       ##
#.  $$ ###
# .##@####
# ## $ ###
#  #. .###
# ###$ ###
#      ###
# #  #####
##########