##########
#  .   ###
#    $####
# ## . ###
# ## $ ###
#  ##  ###
#@##. ####
#  #$$####
#    .####
##########