##########
##    ## #
## $   $ #
##### $. #
#####.$  #
####. . ##
### # ####
#  @   ###
### #  ###
##########