##########
######## #
#######  #
####### .#
### $   .#
# .  # . #
#  ##  $ #
#    $$###
#    #@###
##########