##########
###      #
###    . #
## $ #####
##@$ #####
###   ####
# $ $ ####
# ...#####
##########
##########