##########
#   .   ##
#$  $@$ ##
#  #######
# ########
# ########
#.    ####
#.$ . ####
#    #####
##########