##########
##     ###
# . $ ####
# $.$ ####
##  @#####
###.######
## . #####
## $# # ##
#        #
##########