##########
#. $ #####
#..   ####
#  $ #####
# .#######
# $#######
#$ #######
#@########
##########
##########