##########
## #  ####
# $ $@####
#  #  ####
# # $#####
#. #  ####
#.#   ####
#   .  $ #
#  #   . #
##########