##########
##########
##########
######  @#
######$$ #
###### $##
# ####.. #
#   # $ .#
#    .   #
##########