##########
## #######
# .  #####
#$$# #####
# . $@####
# $# #####
#  #######
#.  ######
#   . ####
##########