##########
##########
##########
##########
## #######
#.   $ ###
#.$ $ .###
#$# ##  ##
#@    .  #
##########