##########
#   ######
##.$######
#.  ######
##  ######
#.      @#
#  .#  $ #
##### $$ #
#####    #
##########