##########
#######  #
# #.# #$ #
#@$      #
# $ $ #. #
### ###  #
### ###  #
##   # ..#
#        #
##########