##########
########.#
##@$     #
### $. $ #
#######$ #
#######  #
#######..#
#######  #
##########
##########