##########
######   #
###### $ #
######   #
#######$ #
### $ .$ #
###.   . #
###  .# ##
####@ ####
##########