##########
##########
##########
##########
#  .  ####
#  .$#####
##$. #####
# $$.#####
#  @   ###
##########