##########
##########
##########
# ########
#    #####
# .  #####
# $.######
# $.   $@#
# $ .  ###
##########