##########
##########
##########
####### ##
###  ##@ #
### $ .$$#
### . $  #
####### .#
##### .  #
##########