##########
##########
##########
##########
##########
########.#
#   ###. #
## $@ $$$#
## . .   #
##########