##########
####  #  #
## $  $$.#
##@$..   #
###  .## #
#######  #
######## #
#######  #
######   #
##########