##########
########.#
#######  #
#######  #
##  #### #
## $  ## #
##    # .#
###$$. $@#
#      . #
##########