##########
#   . ####
# .  $#  #
##$.   $ #
##  # .$ #
#######  #
######## #
####### @#
#######  #
##########