##########
###  # ###
## $    ##
##@$    ##
###   #  #
#### #   #
#### #..##
# .$ $.  #
#       ##
##########