##########
#  # # ###
#   .  .##
#    #   #
# #### .##
# $@$   ##
#  $ #  ##
# $#######
# .#######
##########