##########
#   ######
#..$ #####
#   ######
# $$.#####
# .$@#####
#  #######
# ########
#  #######
##########