##########
#####   ##
#####.$ ##
#####$ .##
###   .$ #
####  . ##
######$ ##
######@###
##########
##########