##########
#    # ###
#..  $@###
#  $ # ###
# ########
#  #######
#.$ ######
# $ ######
#   .#####
##########