##########
# .   $@##
# . .$ ###
# $$######
#   ######
# .#######
# ########
##########
##########
##########