##########
#   ..####
#$$$ #####
#     ####
#  #$ ####
#  #@#####
#. #######
#  #######
#  . #####
##########