##########
##########
##########
#@ #######
#$$ ######
# . ######
#   ######
# $## $.##
#.  .  ###
##########