##########
##  @#####
###$$#####
###  #####
###  ##  #
###..##$ #
### $##  #
###  .#  #
####.    #
##########