##########
## .. ####
## $ @####
###$  ####
###   ####
###$  ####
### .#####
###$. ####
###  #####
##########