##########
# ########
# @#######
# $#######
#. #######
# $  ##  #
#$ ... $ #
#    #   #
######## #
##########