##########
##########
##########
#   .  ###
# $. $ ###
##  .#####
### $ ####
## $.@####
##   #####
##########