##########
#  #######
#  .######
#   ######
#  ####  #
# $##    #
#  ###$$.#
# ###.$. #
#@       #
##########