##########
#        #
# $ ..#$.#
#####  $ #
#####@.$ #
#######  #
##########
##########
##########
##########