##########
###..    #
##.$     #
# $ ###$ #
#   ###  #
# $ ####@#
#   ### .#
#  ##### #
#  ##### #
##########