##########
####### .#
######   #
#### .$$.#
####   $ #
#######  #
#######. #
########$#
########@#
##########