##########
##.   .. #
# $$ #   #
#  $###$ #
# #  @   #
# #### ###
#.   #####
#  #######
#  #######
##########