##########
## . .  ##
##  $   ##
##$ ######
##  ######
# $.######
#.  ######
###$ ## ##
##@      #
##########