##########
##########
##  ## ###
#      $ #
#.   # $ #
#   ## ..#
#  .##  ##
######$$ #
#####   @#
##########