##########
#####@  .#
#  #  #  #
# $      #
# $.# $$ #
#  ###. ##
#.##    ##
# ##  ####
#    #####
##########