##########
####  . @#
##### .$ #
######  $#
#######  #
#######$ #
####### .#
#######$ #
######  .#
##########