##########
#        #
# $@#    #
# . ##   #
##  ###  #
## $.### #
## #.$ $ #
#     .  #
### ######
##########