##########
##########
##########
#@ #######
#$. ######
#. #######
# $ ######
#.$ #  ###
# $ .    #
##########