##########
#### $ . #
####@$   #
####### .#
#######$ #
#######..#
#######  #
# #  ##$ #
#        #
##########