##########
##########
##########
#.       #
# .$##  ##
# $ ######
#@$ ######
# $ ######
# ..######
##########