##########
##########
##########
##  ######
# $ $ ####
#.$ ..####
# @.######
# $ ######
#      ###
##########