##########
##########
##########
##########
#####@ ###
#####$$. #
#####    #
####  #$.#
#   ..$  #
##########