##########
##########
#   ######
# $#######
#  #######
##. ######
#  #######
#   .$ $ #
# . .  $@#
##########