##########
#        #
### # $# #
#### .$..#
####  #  #
####@ #$ #
#####.#  #
####  ##$#
####     #
##########