##########
######## #
#### .  .#
#### .#  #
#### $#  #
#####@$$ #
#######  #
#######$.#
#######  #
##########