##########
#.   #####
#..$ #####
# $#######
#  #######
# ########
#    #####
# $ $ ####
#@    .###
##########