##########
#####    #
######.  #
####@# $ #
#.  $.   #
# $.   ###
# $#######
#  #######
##########
##########