##########
###      #
####.$$$##
####   $ #
#    ##  #
#   .## ##
#  .    .#
#  #### ##
#  ###@ ##
##########