##########
##########
#. #######
#   ######
# . ######
##$$ # ###
## . # ###
###$ $@###
#    . ###
##########