##########
#..   . ##
# $$ # @##
# #   ####
#  #  ####
# $ $#####
#    #####
## .######
##########
##########