##########
##       #
##   .  .#
###  ### #
###  ##  #
####  #  #
####$### #
####@$ $ #
####.$ . #
##########