##########
##    # .#
# $  $$$ #
# @#     #
##### #  #
#######  #
#######  #
####  #  #
#.  .   .#
##########