##########
## @######
## $ ## ##
### $##  #
###.$    #
###  #.  #
#    #####
# $. #####
#.   #####
##########