##########
##########
##########
#######  #
####### $#
#######. #
#######$@#
# $ $.  .#
#  .     #
##########