##########
#.  ### ##
#.$    .##
#.  $ $@##
# $#######
#  #######
# ########
##########
##########
##########