##########
##########
##########
##########
##########
##########
#@ ####  #
# $  $ $.#
# . $. . #
##########