##########
#.  @ .$.#
# $ $    #
#######. #
#######$ #
#######  #
##########
##########
##########
##########