##########
# $   . .#
#  . $ ###
#  # #####
# #  #####
# # $ ####
#.#   ####
#  #$ ####
#   @ ####
##########