##########
# .   $@##
#.  $.# ##
#  ##. ###
# $  $ ###
#  #  ####
##########
##########
##########
##########