##########
#### ### #
##   $ . #
### .. $ #
###  ##  #
####  ## #
### .$@$ #
####  #  #
######## #
##########