##########
#######  #
#######  #
#######$ #
######@$ #
######$$.#
######  ##
####  . ##
#   . .  #
##########