##########
#. #######
# $#######
#   # ####
#  .$ ####
#     ####
#$###$   #
#@##  .  #
####   . #
##########