##########
# ########
# #####  #
#    .$. #
#.  $ #  #
# $####$ #
#. #### @#
#   #### #
#   ######
##########