##########
# ########
#.########
# ####@ ##
#. ###$$ #
# $$ .   #
#     .  #
# ########
##########
##########