##########
#  #######
#$@#######
# ########
#.###  ###
#   .  ###
#. ##$ # #
#  # $ $ #
#  #.    #
##########