##########
###### ###
### .    #
### $# $ #
###  ##  #
####  # .#
####.## .#
## #  #$$#
#     #@ #
##########