##########
###   @###
###$ #####
### #   ##
### #$ ###
##    . ##
##$ ##$###
#.   #. ##
#  .    ##
##########