##########
#######. #
####### $#
#######  #
#######$ #
###### $.#
######@. #
###### $.#
#####    #
##########