##########
###      #
### .  # #
### . ## #
###. ##  #
### $$ # #
####   $ #
###@.##$##
###      #
##########