##########
##########
#.  ######
# # ######
# #  #. ##
# $$.  $@#
# .   $ ##
# ########
#  #######
##########