##########
#######  #
#######$ #
#######  #
######   #
#######  #
####     #
##@.$ $ ##
## $. . .#
##########