##########
######## #
######   #
#.###    #
# ### .# #
#. ##  ###
# $## .###
#   $$$###
#  ## @###
##########