##########
#       ##
#@. ## ###
## # $  ##
#.   $ ###
##  $. ###
#####$ ###
##### .###
##########
##########