##########
# ########
#  #######
# ########
#   ######
#$.   $@##
# $ #. ###
#. ##$ ###
#   .  ###
##########