##########
##########
#######@##
###    $##
#### #  ##
#  ###  ##
# .###. ##
# $$ # $.#
#  .     #
##########