##########
#        #
#   # $  #
#  #####.#
### ##  .#
## .  $  #
### $  . #
##    $###
##  ##@###
##########