##########
# ########
#. #######
# $#######
#  #######
# $#######
#  $@#####
#. $.#####
#  .######
##########