##########
##########
##########
#  ### ###
#    . @ #
#. #  $$ #
#  ###  ##
# ####.$ #
# $  .   #
##########