##########
#    #####
# $. #####
#.. . $@##
# $$ #  ##
#  #######
# ########
#  #######
#  #######
##########