##########
###    . #
###  $   #
## # ##..#
##  $ #  #
#  .  #  #
# $ # ## #
##$   #  #
##  @    #
##########