##########
##########
#  #######
# $##@####
# .##$####
# $#   ###
# $. . ###
#.    ####
# ########
##########