##########
###.######
###  #####
# .$ #####
# .  #####
#   ######
# $. #####
# $$ #####
## @ #####
##########