##########
# .   $ .#
#.   #   #
# $### . #
#  ####$ #
#  ####  #
########$#
########@#
##########
##########