##########
####### ##
###### .##
####     #
###### $ #
#######  #
### ## #.#
# $@.$ $.#
#        #
##########