##########
####   . #
####.    #
#### $   #
#######$.#
#######  #
######## #
##### ##$#
##  .  $@#
##########