##########
##.      #
## $ .$ .#
######.$ #
####### $#
########@#
##########
##########
##########
##########