##########
######  .#
#      . #
#.# $   ##
#  ####  #
#  ####  #
# #####.##
#$ ## $$##
#    @   #
##########