##########
#      . #
#    # . #
# ####  .#
# #####$$#
# ## ##  #
# $@$    #
#     # .#
##########
##########