##########
#####    #
##### $$@#
###### $##
#  ###.$ #
#  ###  .#
# ####  ##
# ## #  ##
#  .    .#
##########