##########
# ########
#  #######
#.$#######
#  #######
#.$  #####
#@$   $  #
# .#     #
#.########
##########