##########
#. #######
#  #######
#. #######
#  ##### #
# $##### #
#     .  #
# $# $ $@#
#  #### .#
##########