##########
##########
##########
##########
#######@##
#.#####$ #
#$ ####  #
#.$ ##  .#
#.     $ #
##########