##########
#    #####
#  $ #####
### . # .#
##   ##$ #
## $ ##  #
### ###  #
## @# $. #
##.      #
##########