##########
##########
##########
##########
##########
# ########
#  ## .  #
# $ $ .  #
#@$. . $ #
##########