##########
#.    ####
#.  # ####
# $#######
# $@######
# $ ######
# .#######
#.$#######
#  #######
##########