##########
##### ####
#       ##
#  .  $ ##
#  ##@  ##
#.####.###
#  #    ##
# $# $$ ##
#  .  ####
##########