##########
######## #
######@  #
#######. #
# $    $ #
#    ..$ #
# $#######
#     .###
#    #####
##########