##########
##########
##########
##########
### ## . #
# $ $   ##
# #@$.  ##
#  ###$. #
#       .#
##########