##########
#######@##
#######$##
#######  #
#######  #
######  $#
######$  #
#### # $.#
#  ..  . #
##########