##########
#@ #######
#$.#######
# .#######
# $.  ####
# $  #####
#  #######
# $#######
#. #######
##########