##########
# .   ####
#   $  ###
#  # ## ##
## #    ##
#  #   $@#
##  #  $ #
##.##.$###
#.      ##
##########