##########
####    ##
### . $ ##
### $#####
###  #####
####  ####
####@.####
###.$ $ ##
#      . #
##########