##########
##########
##########
##########
##########
#.  ###@ #
#$$  ##$.#
#.    $. #
#     #  #
##########