##########
#.  ######
#   ######
#.$ ######
# $#######
# .#######
# $#######
#.$@######
#  #######
##########