##########
#..#######
#    $.###
#   #  ###
# ##  ####
# ##  ####
#$@#  ####
#   #$$ ##
#       .#
##########