##########
###  #####
### $@####
### $#####
###$ #####
###   ####
###$.#####
##  .  ###
##.     .#
##########