##########
##     ###
##@$$.####
### . ####
### .#####
###.$ ####
###  #####
### $ ####
###  #####
##########