##########
#   @    #
#  $  $  #
#.#####  #
# #  ##  #
#   .##  #
#  $  ## #
###$ ### #
###  .  .#
##########