##########
#######  #
###  ### #
# $ .  $ #
# $.   . #
#@#####  #
# #### $ #
# ####   #
# ##   . #
##########