##########
#.########
# .#######
#.$#######
#   $@####
# $ ######
# $#######
#  #######
#. #######
##########