##########
#   ######
#@$ .#####
#  #######
# # ## .##
#.$      #
# # $ $ .#
#######  #
######## #
##########