##########
#       ##
# #      #
#. ## @ ##
# $##   ##
#  ##   ##
#.$ ### ##
#$   $. ##
#   .#  ##
##########