##########
# .$.    #
#  $.$ .##
#   ######
##$#######
##@#######
##########
##########
##########
##########