##########
#  .     #
# $    $.#
###.  #.##
### $@$ ##
#### #  ##
##########
##########
##########
##########