##########
#####   ##
#####   ##
## ####  #
##   ##  #
##.  #  ##
##.# $. ##
# .$$@$ ##
#        #
##########