##########
#      . #
#   # #  #
# ####   #
# ### $.##
#  ###. ##
# ####$ ##
# ###.$$ #
#####  @ #
##########