##########
##########
##########
##########
##@#######
##$  #####
#  $## ###
# . .. $ #
#    $  .#
##########