##########
######## #
# .     .#
#  @# $$ #
#######  #
######## #
#####.  .#
## # $$# #
#        #
##########