##########
######  .#
###### $ #
###### $ #
#####@$. #
###### .$#
##### .  #
######  ##
######   #
##########