##########
##### @# #
# ## $$  #
#  #  .$ #
#. # $ ###
# .    ###
# .  #####
# ########
# ########
##########