##########
#   ######
#$$ ###  #
#.. ###  #
#  .#### #
#   ###  #
## ####$ #
##$ ###  #
#  .   @ #
##########