##########
##########
##########
##########
##########
## ###  ##
#  ..$ ###
#@$. $ ###
# $  .  ##
##########