##########
####  .$ #
###  $ $ #
##### .  #
####### .#
######  .#
#######  #
######@$##
##      ##
##########