##########
###     .#
##  $.# .#
##  ###  #
##  ###  #
## . ##  #
## $###  #
##  ###$$#
#    #@  #
##########