##########
#   @  ###
# $## ####
#    # ###
# ##     #
#.##.$ $ #
# ######.#
# $     .#
#  ##    #
##########