##########
##########
##########
##########
#### #####
### ..  ##
###$.@ ###
## $$$. ##
#      ###
##########