##########
#.. .  $@#
# .$  $ ##
### ######
# #  #####
#    #####
#    #####
# #$ #####
#    #####
##########