##########
##########
####  ####
####$@####
#  $.#####
# #$  ####
# # .#####
# .  #####
# $  .   #
##########