##########
##########
##########
##########
## #. ####
#@$   .  #
# . $ $. #
# $#######
#   ######
##########