##########
#  #######
#  #######
# ########
# .#######
# $#######
# $ ####@#
# $.   $ #
#.  . #  #
##########