##########
#####    #
##### $$ #
######.# #
#####  # #
#####  #.#
#####    #
##   #$#.#
#@$  .   #
##########