##########
##########
#######.##
# # ## .##
# $   $$ #
# .$  .  #
#  #######
#@########
#  #######
##########