##########
#   . .. #
# $###   #
#  ####$@#
# #####  #
# #####$ #
# #####  #
#  ##### #
#  .   $ #
##########