##########
### .  . #
###$ . $ #
### $  $ #
###.@#####
###  #####
##########
##########
##########
##########