##########
#.  ######
# . ######
#   ######
#  #  ####
#.$ $  ###
## # $ #@#
##.#$  # #
#        #
##########