##########
###      #
### $$$  #
### $ #  #
####. ## #
###  ### #
###@ ### #
### .  # #
####.   .#
##########