##########
##### #. #
##### .. #
#####  $$#
#######  #
#######$@#
####### .#
#######$ #
#######  #
##########