##########
##########
##########
##  #### #
## $   $ #
##    ##.#
###$###  #
#. $ @.. #
##       #
##########