##########
#   ######
# $#######
# .#######
#.# ###  #
#.     $ #
#. $ #   #
###### $ #
#######@##
##########