##########
#######  #
#######$ #
#######  #
####### .#
#@$.     #
# $.$ # .#
### #### #
#        #
##########