##########
##########
####@ ####
####$$####
####   ###
####. $###
#####$ ###
##  #.  .#
#      . #
##########