##########
##########
##########
#@########
#$ #######
# $#######
#. #### ##
#   $  $ #
#..     .#
##########