##########
##########
##########
####     #
#### $ $##
#### $. ##
# #####  #
# ### .$ #
# @  .  .#
##########