##########
#        #
#.  .$$ ##
#  ##   ##
# ####$ ##
#.####. ##
###### $@#
######  ##
######   #
##########