##########
######   #
######.  #
#######  #
####@$   #
####$.#$ #
### $ #. #
### .  # #
#####    #
##########