##########
#  . .   #
# $ # .  #
# $  ##  #
## . ##$ #
#######  #
#######$ #
####### @#
##########
##########