##########
#     ####
# $ $ ####
#  #######
# ## @####
# #  #####
#  $.#####
#.$. #####
#. #######
##########