##########
##########
##########
#  #######
# #    ###
# ## .####
# $@$  ###
# $..$####
#.     ###
##########