##########
##### .  #
#####  $ #
####### .#
######  .#
######$$ #
#  ###  ##
# @ # $.##
#        #
##########