##########
##########
##########
#  #######
#@$      #
## $##  $#
# $ ### .#
#   . #  #
#    ..  #
##########