##########
##########
##### ####
#        #
#  # .$###
# ##.  $@#
#  # $# ##
# ##$ . .#
#  #    ##
##########