##########
##########
#### ..###
#### $####
####@$.###
#####  ###
##### ####
# $ $  ###
#    .  ##
##########