##########
##########
##########
##@#######
# $ ######
# .$######
#   ######
# $$ #####
#.. . ####
##########