##########
# ########
#  # #  ##
#  ..  $ #
# $$  $.@#
# . ######
##########
##########
##########
##########