##########
#### .   #
#### . $ #
##### # .#
##### ## #
####@$ . #
##### $$ #
#######  #
#######  #
##########