##########
#. #    ##
#   $$$@##
#. #  $###
# ####  ##
#.      ##
#.## #####
# ########
# ########
##########