##########
######## #
#######  #
#######$ #
######   #
######$ .#
#####  # #
#@$   .$ #
# ##.   .#
##########