##########
##########
##########
#### ## ##
# @      #
## $  ..$#
###### . #
#  ###$$.#
#        #
##########