##########
#. #######
# $#######
#. #######
#$  ######
#  #######
# @#######
#$.$   ###
#   .#####
##########