##########
##########
####   ###
##### $###
#### ..###
#####.####
##.  $ ###
## $ $ ###
### @   ##
##########