##########
#  .######
# $ . $@##
#  $ $ ###
#  ##. ###
####   ###
####.  ###
##### ####
##########
##########