##########
#####    #
##### $@.#
#######$ #
####### .#
######## #
#######  #
##### $$ #
#  .    .#
##########