##########
##       #
## $    .#
######## #
#  @ ##  #
#.    $. #
#   $ .  #
# $ ######
#    #####
##########