##########
##     . #
##  $  $ #
### ######
###  #####
###  #####
##  ##   #
#@ $# .$ #
#   .  . #
##########