##########
#  ##  @##
# ####$###
#  ### ###
#   #  ###
#.   $. ##
#   # . ##
# ## $$###
#  .    ##
##########