##########
#####@   #
#   ..   #
# #  .   #
# $ ###  #
#.$ #### #
#   ######
# $$######
#   ######
##########