##########
###    . #
### $. $@#
####$ ####
###  #####
###  #####
###$ #####
# #   ####
#  .. ####
##########