##########
#   @  ###
# $ $ ####
## #######
## # #####
#. #    ##
#  # $ ###
#.  # $ ##
#    . .##
##########