##########
#####    #
##### $$ #
######@. #
###### .##
###### $##
######. .#
#######$ #
#####    #
##########