##########
#   ######
#$. ######
#  #######
#. #######
# $#######
#  @ #  ##
#.# $ $ ##
#  .    ##
##########