##########
######## #
#######  #
### ###$ #
# $    . #
# $. .   #
# #####. #
#@#####$ #
#######  #
##########