##########
# @#######
#$########
#   ######
# $#######
#   ######
#..#######
# .  $ ###
#.$    ###
##########