##########
#     @  #
#.$ $ #  #
# ########
#  #######
#.########
# ##  ####
# $  $.###
#.     ###
##########