##########
#      @ #
# $ .$ $ #
###### #.#
###.     #
#### $ ###
## .  ####
### ######
### ######
##########