##########
###   .  #
##  #  $ #
##  ###$ #
####### .#
#######$ #
### ###. #
#@$     .#
##    #  #
##########