##########
####.   ##
####  $###
###    ###
###  .   #
####$ ## #
### @### #
##.$$### #
#     .  #
##########