##########
########.#
#####    #
#####  $ #
####@# # #
####$  ###
### .$ ###
##.$ # ###
#   .  ###
##########