##########
####### .#
#######$ #
#######  #
#####  $ #
###### ..#
###### #$#
###    $@#
### .   ##
##########