##########
#   .#####
# $ $ ####
#     ####
##    ####
#  # #####
#@#.  ####
#  $$ ####
#  . .####
##########