##########
#### .  ##
#### $$ ##
###@$ .# #
#### $.  #
#####    #
#######  #
## ###   #
#     .  #
##########