##########
######## #
#######  #
#######$ #
#######  #
######. .#
###### $.#
#####  #$#
#####. $@#
##########