##########
#######  #
#######$.#
#######  #
#######$ #
#######. #
## .  @ .#
##  $ #$ #
##   ##  #
##########