##########
##   #####
### ######
###.  ####
## .$#####
###   ####
##   #####
###$$@$ .#
###   .  #
##########