##########
##### ####
####   ###
####$  ###
####  ####
###   @###
# $$#. ###
# $.. ####
#  .   ###
##########