##########
# ########
#  .  ####
#.$$ $####
# $@#  ###
# ## .####
#.##  ####
# ##  ####
####  ####
##########