##########
#   .@ ###
# $$  ####
#. #######
# $#######
# $. #####
#.  ######
# ########
#  #######
##########