##########
#        #
##$ # # .#
## ##### #
#. ##### #
#  ####  #
#  ###. $#
#$ # # $@#
#.     ###
##########