##########
##########
##########
####.  ###
#. .   ###
# $ $. ###
# #  $####
####$ ####
###@ #####
##########