##########
##########
##@#######
##$#######
##  ######
# .$######
#   # ..##
# $ $   .#
#        #
##########