##########
#######  #
#######$ #
#######  #
#######$.#
####### .#
#####@#. #
#### $$  #
####   . #
##########