##########
##########
##########
##########
##  ######
##$ ######
##  # #@ #
# $ . .$ #
# ..   $ #
##########