##########
#######  #
#######  #
# #####  #
#.  ## . #
# $ $.   #
# # $##  #
#@ $. #  #
#   ######
##########