##########
#####  ###
#### $ ###
#####  ###
#### . ###
#@$ ..####
# $ $ ####
####   ###
####  .###
##########