##########
#        #
#   # $$ #
# #### $ #
# #. #   #
#      $ #
# . .@.###
##########
##########
##########