##########
##########
###   ####
#  $ #####
#@$  #####
## ##.####
#        #
#.  #  $ #
#  $  . .#
##########