##########
#  #######
#@ #######
#  ###  ##
# # ##$.##
# $      #
# #.$  $.#
#  ### .##
#  #### ##
##########