##########
##########
### ######
# . @.   #
# $    $ #
## #######
#       ##
# $# $. ##
#   .    #
##########