##########
## #######
# .    ###
# . $#####
#.$# # #@#
#  $ . $ #
#    #   #
# ########
# ########
##########