##########
###### . #
###### $.#
#######  #
####### .#
#######$ #
####### $#
#####@$ .#
######   #
##########