##########
#    #####
# $$ #####
#  @######
#   ######
# ########
# ##.#####
#.. $ $ ##
#.      ##
##########