##########
####     #
###    $ #
# $. # ###
#.##$#####
# # . ####
#  # #####
#   $@####
# .   ####
##########