##########
#        #
#  .  $ ##
# ##### ##
#  #######
# $#######
# .## .###
# ##   $@#
# .    $ #
##########