##########
#####. . #
##@$    ##
## $ $$# #
#####  # #
####  # .#
####     #
#####   .#
######## #
##########