##########
#    #  .#
# $  ..  #
# ##.##  #
# $ $    #
# $#  #@ #
#  #######
# ########
# ########
##########