##########
#@ #######
#$########
# .#######
#   .#####
# $  #####
# #$  ####
#.$. #####
#    #####
##########