##########
#@.#######
# $#######
#  #######
# .#######
# .#######
#      ###
# $$#  ###
# $  .####
##########