##########
#        #
#. $. .  #
#   ######
#$ #######
#   ######
## #######
##$ ######
#@$.   ###
##########