##########
##########
##########
#####  ###
##### $@##
##### $###
##### . ##
## $ .$ ##
##  ..   #
##########