##########
# @.     #
#  $ # $.#
# $####$ #
#. ####  #
# ######.#
# ########
##########
##########
##########