##########
##########
##########
#######  #
# $    $ #
# #  $#$ #
# ##@ #  #
#  #  .  #
#   ...# #
##########