##########
#   .  ###
#    $ ###
## ### ###
#   ## ###
#..#######
#. #######
#$$ $ ## #
#@       #
##########