##########
####@.  ##
####$$$ ##
#. #  ####
#      ###
#   .#####
#  $ #####
# #. #####
#     ####
##########