##########
# $@   .##
#    #$.##
# ####  ##
# $ .$  ##
# ##  . ##
##########
##########
##########
##########