##########
##########
##########
#. #######
#   ######
# .$######
# $ ######
#  .  $@##
# $ . ####
##########