##########
##########
##########
##########
##########
###### @.#
######$. #
## # .$$ #
#.     $ #
##########