##########
#      ###
#$ # #  ##
# ####@###
# ####  ##
#   $  ###
# $# #####
#..$ #####
#. . #####
##########