##########
##########
#    #####
# $$######
#    #####
##  . ####
#    $####
#@ #  $  #
##.#  .. #
##########