##########
#  #######
#  #######
# ########
# .  #####
# $$@#####
#. #######
# $   $ ##
#   . .  #
##########