##########
### ######
### ######
##  #..###
# $.  @###
#  $ $ ###
### ##   #
## $. #  #
#       ##
##########