##########
####     #
#### .## #
#### $#  #
####@.  .#
####  $ $#
#######  #
#######$.#
#######  #
##########