##########
###  #####
### $$  ##
###  # ###
# $ $. ###
#. . #  ##
#.#    ###
#  ##  ###
#     @###
##########