##########
# ###### #
#@### .. #
#  #  $$.#
#  ## # .#
# ###  #$#
# ### #  #
# $      #
#  ##    #
##########