##########
##########
##########
######   #
######$@ #
###### ..#
######$ ##
#  ##.$ ##
#.    $ ##
##########