##########
#  #######
# $#######
#    .   #
# ####   #
#. ##### #
# #####  #
#  . $@$ #
#.  $ #  #
##########