##########
##########
##########
#@########
#$## #####
# .  #####
# . $#####
# $$  ####
#. .  ####
##########