##########
###  #####
## .######
##.$@  $ #
##  $#   #
##   ### #
###.$#   #
##.      #
### #    #
##########