##########
# . ######
#$  ######
#   ######
#$. ######
# $#######
#.@#######
#.$ ######
#  #######
##########