##########
#######  #
#######  #
#######$.#
#######  #
####### .#
#    $.@ #
# . $ #$ #
# #####  #
##########