##########
#  ##### #
# .$   # #
# .$  #  #
##$  .#  #
##@#  #  #
####$.#  #
####  #  #
#####    #
##########