##########
##########
##########
##########
##########
#######. #
####  #.$#
### $  $.#
# .    $@#
##########