##########
#  @     #
# $ $$$ ##
####  ####
##### ####
#####.####
#  #  .###
#      ###
# . . ####
##########