##########
#    #####
# $$ #####
#   ######
### ######
##  ######
##@.   ###
## $#.$ ##
##.   . ##
##########