##########
# ########
# .#######
#.$#######
#   ######
# $#######
# @#######
# $$.#####
# . ######
##########