##########
#   ..  ##
#.  # $.##
## $ $ ###
#    # ###
## #######
## #######
##$ ######
# @   ####
##########