##########
#        #
# $ $ $. #
## # ### #
######   #
######.  #
#######  #
###### $.#
######@ .#
##########