##########
#  #@#####
#.$ $$ $ #
#.    .  #
#  ###.  #
# ########
##########
##########
##########
##########