##########
########@#
####### $#
######## #
##   ##. #
##  ###$ #
##   ##  #
### $ $  #
### ..  .#
##########