##########
######@###
######  ##
# ###  $ #
# . $ $  #
#  # $   #
# ### # ##
#   . . ##
#  #   .##
##########