##########
# .#######
#  #######
#  @ #####
# . ######
#$$. #####
# $ ######
# $ ######
#.  ######
##########