##########
# .#######
#@$$. ####
# $.$.####
#     ####
## #######
##########
##########
##########
##########