##########
#@########
#$########
#  #######
#.  $  ###
#   $ ####
# .##.####
#.$#  ####
#     ####
##########