##########
#######.##
######.  #
####@$ . #
#####.$$ #
##### $  #
#######  #
#######  #
######## #
##########