##########
##########
##########
#######  #
###### $ #
######$  #
######   #
#### $ ..#
##@$ . . #
##########