##########
# ########
#  #  ####
# ..  ####
# .#  ####
#  $$#####
# $ @#  ##
# #$###  #
#    .   #
##########