##########
#######@ #
#######$$#
######.  #
######   #
#####  # #
######$..#
#####.$  #
#####    #
##########