##########
#######  #
#######$.#
#######  #
#######$ #
#.#####  #
# ##### .#
#$### $  #
#      .@#
##########