##########
##########
#      ###
# $ .@####
# $#  ####
##  ######
##. ######
# $.$ ####
#    . ###
##########