##########
##########
# ########
#.########
# #  ##  #
#    .$$ #
# .$   $@#
###. #####
#### #####
##########