##########
##########
##########
######## #
#######. #
######@$ #
##### $$.#
#####.$  #
####  .  #
##########