##########
#     . ##
# .  $  ##
### .# $.#
###  #   #
## $######
##  ######
## $######
#  @ #####
##########