##########
#.   #####
#.  .$  ##
# #    ###
#  #$#####
#   $@####
# . ######
# $#######
#  #######
##########