##########
#      ###
# $.$  ###
#####   .#
#####.# $#
#### ## .#
#        #
# $#    ##
# @#######
##########