##########
#    #####
#$ $ #####
#    #####
# #    ###
#.#  # ###
# .#######
#.$$ #####
#   @  . #
##########