##########
#        #
# . # .$ #
#  ###$..#
# $### $ #
#  ####  #
# ########
# @#######
#  #######
##########