##########
##########
###  ## ##
#@$  $   #
### $ .. #
#####  ###
#  ##.####
# ##   ###
#  .$ ####
##########