##########
# ..   $.#
#   $ #  #
#  ####$ #
# $####@ #
#  ##### #
#.########
# ########
##########
##########