##########
# @#######
#$$#######
#.  # ####
#  $. ####
# .   ####
#.$#######
#  #######
##########
##########