##########
## #######
## ####  #
# @ ### ##
#  ### . #
#   ## $ #
#  ###. .#
# ## #$$ #
# $   .  #
##########