##########
##  @#####
##$    $ #
#     .  #
#. ##### #
#   ### .#
# #####$ #
#$ ## #  #
# .      #
##########