##########
#######. #
####### $#
#######  #
#####@$ .#
###### $ #
###### . #
###### $ #
####### .#
##########