##########
#####  # #
####@$ # #
#####$   #
##### #$.#
####  #. #
####     #
#####$   #
####  .. #
##########