##########
# . $   .#
#.$ #    #
#  #######
#@$#######
#. #######
# $#######
#  #######
# ########
##########