##########
#    ... #
# #   $  #
##### $  #
#######$.#
#######  #
######## #
## #### $#
#@       #
##########