##########
##  .    #
####  .  #
#####$ $ #
##### .$ #
##### # .#
####     #
#### $####
#####@####
##########