##########
# @      #
#$# # $. #
#  ####$ #
# ####   #
# ##### ##
#  ####  #
# $###   #
#.   .  .#
##########