##########
#  #######
#  ##### #
# ####   #
# $   $. #
# # $  ..#
# ##### .#
#    ##$ #
#@  ###  #
##########