##########
##########
##########
##########
######## #
#  ##### #
# $### # #
#.  $ .$ #
# ..   $@#
##########