##########
######   #
# ####@  #
#    ##$ #
# $ $##  #
#    .#  #
#.$      #
#   # .. #
##########
##########