##########
##########
#  #######
# $$  $@##
#  .   ###
# #  .####
# .# #####
#  .$ ####
#       ##
##########