##########
##########
##########
##########
##########
#### # .##
#### $ $ #
### .$ $ #
###@. .  #
##########