##########
##########
#######@ #
#######$ #
#######  #
######. .#
###### $ #
######.$$#
### .    #
##########