##########
#### $ . #
####  .$ #
#### .#  #
####  #  #
#####.#$ #
#######  #
##### #$@#
####     #
##########