##########
######## #
####@ ## #
#### $   #
##### $  #
####  #..#
#### $$  #
#### .  .#
##########
##########