##########
####### .#
# $ .$ . #
# .    $ #
####### @#
######## #
#######  #
####### $#
###      #
##########