##########
##########
##########
##########
##########
# ##     #
#@ #.$. ##
# # #$$  #
# $ .  . #
##########