##########
##########
##########
##########
## . #####
# @ . .###
# $. $ ###
# $##$####
#     ####
##########