##########
#    .   #
## $$$.###
####.  ###
##     ###
##.  #####
## $######
###@######
##########
##########