##########
##########
##########
#  ###@###
#    $$ ##
# $.  . ##
#  #$.####
#.## #  ##
#       ##
##########