##########
###@$ .  #
#### .$  #
#######  #
#######$ #
#       .#
# $.# #  #
# ########
#    #####
##########