##########
#### $  .#
###..$$$ #
#### @  .#
###### # #
##########
##########
##########
##########
##########