##########
# . $@####
#  .$ ####
# $ ######
#..$######
#   ######
##########
##########
##########
##########