##########
##########
##########
###### .##
######$ .#
###### $ #
# $ $ .  #
#@   ## .#
######   #
##########