##########
#     @  #
### . $$$#
#####   .#
#######  #
#######$.#
####### .#
######## #
######## #
##########