##########
# ########
#  # #####
#  #   ###
#. #. $ ##
# #..#$ ##
#   @   ##
#   $$####
#     ####
##########