##########
##########
##########
#  .  ####
#  #.$####
#  #$ ####
# $#   ###
#  #$.####
#@ .  ####
##########