##########
#@$. .# ##
## $     #
####   $.#
####### ##
#### $  ##
####     #
###      #
###.     #
##########