##########
# @###  ##
#$ ### $ #
#  ###  .#
#  ###   #
# #### $ #
#  ####  #
# $###  ##
#.   . . #
##########