##########
#### . $ #
#### ..$ #
### # ## #
#    $ $@#
##  #   .#
##########
##########
##########
##########