##########
##########
##########
#@########
#$ #######
# $#######
#. $ #####
#   $ ####
# .. . ###
##########