######
#### #
###  #
###$ #
###  #
##. .#
## $.#
#  #$#
#. $@#
######