########
#    .@#
#$$#$$##
#  #  ##
#  #.###
#   ####
#     ##
#   . ##
#. #####
########