######
###  #
###  #
#+*$ #
#   ##
#####