##########
# ###.####
#      @##
# $# $####
#  # $.###
# #    ###
# #   ####
# $ . ####
#   . ####
##########