##########
##       #
### .  $ #
### $$####
#### $ ###
####.  .##
#####@ .##
##########
##########
##########