##########
##########
##########
#### #####
#### #####
####  ####
##@$ .####
#.$  $$ .#
#     .  #
##########