##########
##########
##########
# ########
#  .#@ ###
# $. $ . #
# $  .$  #
# ##  ####
# ########
##########