##########
####  # ##
#  $$ $ ##
#   .  $@#
#.#####  #
#  ####  #
# #####  #
#  ####  #
#  .   . #
##########