##########
# .      #
# $ $  . #
#  ####.##
# ####   #
######  ##
######  ##
#######$##
##  .  $@#
##########