##########
#####  ###
####  ####
#### $ ###
####  .###
### $ .###
#### .####
### $$####
#   . @  #
##########