##########
#@########
#$ #######
# #### ###
# .    ###
# .  $ .##
#.$  $ ###
#  #######
#   ######
##########