##########
#    .   #
# $ .. $ #
###  ### #
####  ## #
###  ##  #
###$  ## #
###.$#####
###@  ####
##########