##########
##########
## # @####
# $ $   .#
# $    . #
#    ### #
# ###   .#
##### $  #
####    .#
##########