##########
########@#
####### $#
#######  #
####### .#
#######  #
###   # .#
#### $$ $#
#     .. #
##########