##########
##########
##########
####  ####
#####. ###
#####  ###
# .$  ####
# .$$.$@##
#      ###
##########