##########
#@ #######
#$$ ######
#   ######
# .#######
#.$ ######
# . ######
# $ ######
# .   ####
##########