##########
#  #######
#  . $ $ #
#   #@$  #
# #####$.#
#  ####  #
#.###### #
#.##   # #
#        #
##########