##########
##       #
#.$ . .  #
#  #######
#   ######
#  #######
##$ $  ###
##@$ .####
###      #
##########