##########
##########
##########
##########
#### .####
#### .####
#  .   ###
# $$$ ####
# .  $@###
##########