##########
##########
##########
##########
####. # ##
# $  $   #
#@$.  .  #
#######$ #
####### .#
##########