##########
##########
#@  ######
##$ ######
#  ####  #
#  .##  ##
# $ ##$  #
# $.##  ##
# .   .  #
##########