##########
# $  . . #
#@.$ $   #
#####$  ##
##### .###
#####  ###
##########
##########
##########
##########