##########
##########
# ########
#.########
# ###@   #
#  ##  $ #
# $## $  #
#$ ###  ##
# .   . .#
##########