##########
# . ######
#   ######
# $#######
# . $ ####
#  #$.####
# ##@ ####
#  #.$# ##
#        #
##########