##########
##########
##########
##########
####### ##
######.$ #
#####@$  #
##### $ .#
###.  $. #
##########