##########
######  ##
##   $ $@#
# #  .$ ##
#   #. ###
# $ # ####
#  .######
#  #######
# .#######
##########