##########
##########
##########
####@    #
#### $ $##
#  ### .##
# $ ##  ##
# $ ###  #
#. .   . #
##########