##########
#     ####
# @$ #####
# ########
#  #######
# $#######
#  #  ####
# .$$ . ##
#.    .###
##########