##########
##########
####  #  #
####  $$ #
#####    #
##### ## #
##### .$ #
#  #  #$ #
## ..@ . #
##########