##########
#        #
#      $ #
#.####   #
#@########
#  #######
# . ######
#  $.$ $ #
#       .#
##########