##########
#####    #
#      $.#
# $$ #   #
##@ ###$ #
##.###   #
#####    #
##### .  #
#####   .#
##########