##########
##  ######
## $@#####
##   #####
###$ #   #
###.## $ #
##  #   ##
#   .$   #
# ..   ###
##########