##########
#       ##
#   ..  .#
#.$####  #
# @### $##
#   ##  ##
#    #   #
#  $ # $##
#   ##   #
##########