##########
#.   . ###
# . $ ####
# $ ######
##   #####
# #  #####
# $.######
#  $ #####
###@ #####
##########