##########
# .  #####
#   $ ####
# #   ####
# #  #####
# #  @####
#.#  # # #
#  #$$ $ #
#.    .  #
##########