##########
#  .  ####
#.$.$ ####
#. $ #####
# @#  ####
# $# #####
#  # #####
##########
##########
##########