##########
##########
##########
#@########
#$########
#  #######
# $..### #
#.$ $ #  #
#  .     #
##########