##########
#    .  ##
#  # $  ##
#####.$ ##
#####$$ ##
#####   ##
###### @##
##### . ##
### .   ##
##########