##########
#        #
#$ #$ $ ##
#@ # #####
#...$ ####
#  .  ####
#####    #
#####   ##
####    ##
##########