##########
#     ####
# $   ####
#.  ######
#   ######
##  #  ###
#  $@$  ##
# . # .$ #
######  .#
##########