##########
##########
##########
##### ####
## #     #
#@$   $#.#
#  #.  $ #
# # $ #  #
#  . .####
##########