##########
##########
##########
##########
##########
#####@ ###
#### $$  #
## #$ $. #
#  . . . #
##########