##########
##########
##########
##########
# ########
#  ## @.##
#  ##.$. #
# $ $$.# #
#        #
##########