##########
# @#######
#$$#######
#   ######
#  . #####
# .$ #####
#. $######
##.  #####
###   ####
##########