##########
#        #
# $ $$.. #
# @   # .#
# $#######
# .#######
##########
##########
##########
##########