##########
## # .. ##
#@$   $$ #
##  #    #
##### ## #
####  ## #
####   #.#
##### #  #
####  $ .#
##########