##########
##########
##########
##########
##  ######
#  ####  #
#.$$   $@#
# . $. # #
#  .  ####
##########