##########
##########
##########
#####@####
###  $   #
#  ##. # #
# $ ###  #
# $ ###$ #
#.  ..   #
##########