##########
###  .   #
####   $$#
###  ##  #
###  ### #
####  ## #
####  .. #
####@$ $ #
####### .#
##########