##########
# ########
#@ #######
# .#######
#  #######
# $#######
# $  #####
# $$. ####
#  .. ####
##########