##########
###      #
###  ..$ #
# ##$ ####
# ##   ###
#   $$####
#  ..@####
##########
##########
##########