##########
#  #######
#  . .   #
#.$ #    #
##@##### #
##$ ###  #
#  ####  #
# $# $  .#
#        #
##########