##########
###   ####
###  #####
#  $. ####
#..# #####
#  #$@####
# $ $ ####
# .  #####
# ########
##########