##########
####@#####
#  .$.####
# $  $## #
####   # #
####  # .#
#####    #
####  $  #
####  .  #
##########