##########
#  #######
#. #######
#@########
#   ##.###
#       ##
# $$ # $ #
#$.####  #
#.       #
##########