##########
#  . .  .#
#$$ $  $ #
# #####  #
#  #####@#
# ###### #
# ########
#. #######
#  #######
##########