##########
# ..@#####
#  #$#####
#  $ #####
# $$ #####
#.  .#####
# ########
#  #######
# ########
##########