##########
####### .#
#######$ #
######@  #
#######$ #
#######  #
### ###  #
# .   .$ #
# $ .##  #
##########