##########
#   .  . #
#.   $ $ #
##$###$  #
##@### .##
##########
##########
##########
##########
##########