##########
##########
##########
##########
##@# ##.##
# $$     #
#     $. #
#####.$. #
##########
##########