##########
##       #
## $ $ $##
###. ## ##
# # ##  .#
# $ ###  #
#     .@ #
####  .  #
######   #
##########