##########
#####    #
#####$#  #
## #@ #$ #
# .#   $ #
#      $ #
#  #  .  #
#  #  ####
# . . ####
##########