##########
#   ######
#$ # . ###
# $ $ ####
#.$  .####
#  #######
# ########
#. #######
# @ ######
##########