##########
##########
#   ######
# $#######
#.  ######
# .#######
# $@######
#.$$### ##
#   .   ##
##########