##########
# .  #####
#$#$ #####
# . .#####
# $#  ####
#. # #####
# $#  ####
#   @#####
# ## #####
##########