##########
####     #
##### $. #
#######..#
####### .#
####### $#
#######  #
#######$$#
####### @#
##########