##########
##########
##@  #####
##$$.#####
##. ######
##.$ #####
#   ######
#  $# ####
#    .   #
##########