##########
##########
########@#
### #### #
#  .   $ #
#. $. .$ #
# ###  ###
# ## $####
#     ####
##########