##########
##########
##########
# ########
# .#######
#  @  ####
## $ $   #
####$. . #
####. $  #
##########