##########
##. .  $ #
##@ $ .. #
###$ #####
###  #####
## $  ####
###  #####
#### #####
##########
##########