##########
#   .  . #
# $ $ .  #
##$##### #
#   ###  #
# #####$ #
#        #
#  @   ###
#. #######
##########