##########
######## #
###### # #
##      @#
##  #. $ #
#####$$# #
##  .  ###
##.  .$###
###      #
##########