##########
######.. #
###### $ #
######  .#
#@$      #
## $ $ # #
####  #  #
####### .#
####     #
##########