##########
##@$  .  #
### .$ $ #
### $#.  #
####  ####
###   ####
#    . ###
#   ######
##########
##########