##########
##########
##########
####### ##
######  .#
### $    #
###   #$ #
### $## .#
####@ .$.#
##########