##########
# . .    #
# .  $ # #
# # ###.@#
# #$###  #
##  ###$ #
##  ###  #
## $###  #
##       #
##########