##########
# .      #
# $ $$.$ #
# ## .#.@#
# ########
# ########
##########
##########
##########
##########