##########
#   .  . #
# $#   # #
# .## ## #
# $$   $ #
#. #  ## #
# ###### #
# #####  #
####### @#
##########