##########
##########
# ########
#   .    #
#  #  # .#
# #####$ #
# #####  #
# $@$   .#
#  # $ . #
##########