##########
##########
#  #######
# $# ##  #
# $.  $  #
#@$   #  #
## #### .#
##.####  #
##     . #
##########