##########
#        #
#  . $$. #
#. #  $$ #
#  ####  #
#.########
#@########
#  #######
# ########
##########