##########
##      ##
# $   $ ##
#  .#### #
##. .   @#
##  #  $ #
####### .#
#######$ #
#######  #
##########