##########
##########
###  #####
###.$ ####
# #  .####
#  $$ ####
#. $@#####
#  #######
# .#######
##########