##########
####  . .#
#### $$  #
#####@$. #
#######$ #
######  .#
##########
##########
##########
##########