##########
##########
##########
# ########
#@###### #
#.$  .## #
# $ $##  #
###   #$ #
#    . . #
##########