##########
# .    ###
#     $. #
#  ##    #
##.### $ #
##  ###  #
#  ####$##
##  ##.$@#
##      ##
##########