##########
#  #######
#  #######
#.  ######
#.  ######
# $#######
#.$ .#####
#$$#######
#@   #####
##########