##########
####   . #
#  # $  $#
# . # # @#
# $$  ## #
##   .## #
######## #
#####   .#
######   #
##########