##########
##### #  #
#####    #
#####.$ ##
#### .####
##### #@##
#### $ $ #
####. $  #
####  .  #
##########