##########
##### .###
####   .##
#### $  ##
#####$ ###
##### $###
#####  ###
#   #.$ ##
#   . @###
##########