##########
##########
#  #######
# .#### .#
# $####  #
#  # ##$ #
#@$    $.#
#  #.    #
# ###### #
##########