##########
#  #######
# $#######
#  #######
#.   #####
# # . ####
# ##  ####
#  $  $ ##
# $. .#@##
##########