##########
#######  #
######## #
#######  #
#######$ #
### .  . #
###$ ##  #
## $ #.  #
##@$  .  #
##########