##########
######## #
####### .#
#######$ #
#######. #
#######  #
#######$ #
####@$.$ #
####.    #
##########