##########
##@$. . ##
## $   ###
######  ##
######.###
#####   ##
## ##  ###
#  .$$ ###
#        #
##########