##########
########@#
####### $#
#######$ #
#####   .#
#####   .#
####### .#
##### $$ #
#####  . #
##########