##########
######## #
##### ## #
#####   .#
##### $  #
###### $.#
#######..#
#######$$#
####### @#
##########