##########
#        #
#   $ $ ##
#  #######
# .#   ###
#  #   $ #
#. ## .$@#
#   ###.##
##       #
##########