##########
##########
##########
##########
##########
#### #####
##@$.##  #
# $.$ $. #
#    .   #
##########