##########
#  #######
#.$#######
#. ##.  ##
# $     ##
#@$#  .###
#  #######
# $#######
#      ###
##########