##########
########@#
####### $#
####### .#
### . $. #
#####  $ #
#######$ #
####### .#
##########
##########