##########
#     ####
###$@#####
#      . #
# ## $  ##
#  #### ##
#. ####  #
#$ ##   ##
# .   $. #
##########