##########
##########
##########
# .#######
#   ######
#   $..###
# $. $@###
# $#######
#  #######
##########