##########
#  #######
# .#######
#     .$ #
#. .#  $ #
#  ####$ #
#   ### @#
#   ###$ #
#  ####  #
##########