##########
######  .#
##### $ ##
####@$.  #
##### $$ #
# ###  .##
#    # . #
#   ### ##
#        #
##########