##########
##########
# ########
# ########
# ### @ ##
#  # $$.##
#  .  $###
#. # $   #
#####  . #
##########