##########
#    #####
#  $ @####
#   $ ####
#..  #####
# #   ####
#.########
#  $     #
# $  .   #
##########