##########
##########
##########
###  #####
###  .  ##
###.$ ####
###$$ ####
# .  #####
#  .  $@##
##########