##########
# ########
#. #######
#.$#######
#  #######
#   $ ####
#   $@####
#$.#######
#   .#####
##########