##########
# . $ ####
# ..  ####
#  #$ ####
# $#@#####
# .#######
#   ######
# $#######
#  #######
##########