##########
###### . #
#######  #
#######$ #
#######. #
#######  #
###### $ #
####@$ . #
#### $.  #
##########