##########
#      @##
#    $ ###
# ##. ####
#.##   ###
#  ##$$# #
# ###  # #
#  ##. $ #
####   . #
##########