##########
##  .    #
#  $$ $. #
# $@##  ##
#.########
# ########
#. #######
#  #######
# ########
##########