##########
##########
##########
# . .#####
# $ #    #
#.$ .    #
### @  # #
###  $ $ #
####     #
##########