##########
###   #@##
#..  .$  #
# $   $ ##
# $#######
#. #######
# ########
# ########
#  #######
##########