##########
####     #
#### $   #
#######  #
#######  #
# ###### #
# .    . #
#.$ # $$.#
#  ### @##
##########