##########
##    .  #
##.$$$  ##
##    # ##
###.##  ##
## . #   #
###$ ## @#
##   ## ##
##########
##########