##########
##########
##########
# #####  #
#.$   .  #
# $ #    #
#@###### #
# $  ##  #
#.$  .   #
##########