##########
#   ######
#.$ .   ##
# #.  $ ##
#  #######
# #### ###
#.###  ###
#   $ $ ##
#  @    ##
##########