##########
##  .    #
###  $ $ #
####.    #
######   #
### ###. #
###@ $   #
### .  $ #
#######  #
##########