##########
##########
##########
######## #
######## #
### ###  #
#  . .$$ #
#@$ $ .. #
######   #
##########