##########
#        #
#  . # $ #
#.#. #   #
# $ ##   #
##$ ###  #
## $ #  ##
###@ ##. #
####     #
##########