##########
#####    #
#####   .#
######.$ #
#####  #$#
#####    #
######.$##
### ##$ ##
#@     .##
##########