##########
###     .#
# $  $   #
# ## #####
#@$  #####
#  # #####
# # . ####
#.##$ ####
#   .#####
##########