##########
##########
##########
####### ##
##### .  #
###### $.#
# ## # # #
# $ $ $.@#
#     .  #
##########