##########
######  ##
#### $ $ #
#@$  .. .#
# $. ##  #
#######  #
#######  #
##     # #
##       #
##########