##########
#####    #
####@# $##
### $ $. #
##  ..  .#
####   $ #
#####  ###
##### ####
##########
##########