##########
## . #####
#. .  ####
# $  #####
# # $ ####
# # . ####
###$ ##  #
### $ ## #
####@    #
##########