##########
##########
##########
## # # ###
#.     $@#
#  $ # #.#
#  #### $#
# $# ##  #
#.     . #
##########