##########
# ########
#  #######
#  #.### #
# ##     #
#  # $  .#
# #####. #
# ### #$$#
# .    $@#
##########