##########
#######  #
#######$ #
######.  #
##   #   #
##   #  .#
## $#### #
##   # $ #
#@$  .  .#
##########