##########
## .   . #
## $  $$ #
###### . #
#######  #
########.#
#######  #
####### $#
########@#
##########