##########
#   #    #
#  $ .   #
#.  #. $ #
#$$###  .#
# @#######
##########
##########
##########
##########