##########
##########
#### ##  #
#       ##
# $  $  ##
# #### ###
#@ #   $ #
# $#.    #
# . .   .#
##########