##########
##########
##########
##########
##########
#####   ##
##### $  #
#    $ $.#
#. .@ .$ #
##########