##########
###    . #
####.  $ #
### . ## #
### . ####
####  ####
### $ ####
# # $$####
# @   ####
##########