##########
####   #.#
####. .  #
#### $.$ #
######  ##
######   #
#####  $ #
######$ ##
######@###
##########