##########
###      #
#### . $.#
######$  #
######  .#
######$ ##
###### .##
#######$ #
#######@ #
##########