##########
####     #
######   #
####### .#
## @### .#
###$ ##  #
## .$##  #
##  . $$ #
###      #
##########