##########
# $     .#
# $  . $.#
# ####.$##
#@ ###   #
#  ####  #
#  #### ##
#  #######
#  #######
##########