##########
##########
##########
####### ##
###     ##
#  .. $  #
#. # ##  #
#$ ##  $##
#  .   $@#
##########