##########
# $ ...  #
#@.$$  $ #
#    #####
##########
##########
##########
##########
##########
##########