##########
##########
#######  #
######## #
#######  #
#######  #
###.# #  #
###$$ .$ #
###@$ .. #
##########