##########
##########
##########
##########
#   ######
# $ ######
#..###@ ##
#.$$ .$ ##
#        #
##########