##########
#  .######
#.   $ ###
#$ .$ $@##
# .##  ###
#  ###  ##
#####  ###
#####   ##
#####  ###
##########