##########
# .      #
# $  $ $ #
### $#####
### @ ####
####. ####
###   ####
###. .####
##### ####
##########