##########
##########
#######. #
#######@ #
#######$ #
#####  . #
###### $ #
##### $$ #
#### . . #
##########