##########
###### #@#
####  $. #
#### . $ #
####. ## #
#### ##  #
#### ##. #
### $# $ #
###      #
##########