##########
#  #######
#. $@#####
#.  ######
#$  ######
# $ ######
# $ ######
# .#######
# .#######
##########