##########
#  .  .  #
# $ $  $$#
# ##### .#
# #### . #
#  ###   #
#  #######
#@ #######
# ########
##########