##########
###@$ .  #
#### $  .#
####..$$ #
#####  ###
##########
##########
##########
##########
##########