##########
#.$ $.####
# $ $#####
#  .  ####
# ##  ####
#.## #####
#     @###
### #  ###
##########
##########