##########
##########
##########
#####    #
# .$ ..  #
# $ $  . #
# ##### ##
#  ### $ #
#@      ##
##########