##########
##########
## @######
# $$###  #
#   #### #
##   ##  #
## .  # .#
## $ $.  #
##  #   .#
##########