##########
#       ##
# $. .  ##
# .##  ###
##$##$ @##
#  ##  ###
#   ## ###
# $##  .##
#       ##
##########