##########
#   ######
# .$######
#.  # # .#
#    . $ #
#   # $$ #
#######  #
######## #
########@#
##########