##########
##########
### ######
#@  ######
# $$######
#   ######
##$  # ###
##. . $  #
###.   . #
##########