##########
##########
##########
##########
##########
###.@#####
# # $  ###
#.$$.$.###
#       ##
##########