##########
#.   #####
#.  .#####
#.$#######
#  #######
#$ #######
# $@######
# $ ######
#  #######
##########