##########
#     .$ #
#    ##  #
# ###### #
# ###### #
# ##  .  #
###@$. $ #
### $ ####
#### .####
##########