##########
##########
##########
##########
##########
# @#######
# $.######
#    $ $ #
# $..  . #
##########