##########
##########
##### ####
##      ##
##  #.$###
##  #. .##
##  #. $##
#### $ $ #
##@      #
##########