##########
###      #
##      ##
##$.######
## @######
#.$  #####
#       .#
#### $$  #
#### .#  #
##########