##########
# #  #####
#.$ $#####
#.   .####
#. $ #####
#  #######
##  ######
# $#######
#    @####
##########