##########
##########
##########
##########
#  #   ###
# $#..$###
# .    $@#
#. #  $ ##
######  ##
##########