##########
####     #
###.  $$ #
#### #  .#
###  .#  #
### $.@ ##
###### $##
######   #
##########
##########