##########
#      ###
# $.$$ ###
# ### .###
# ##  . ##
#  ####$##
# ####   #
#        #
#.   @   #
##########