##########
# #   ####
# @    ###
#$ #######
#  . .####
# $#   ###
#  #$  ###
# ## $ ###
#. .  ####
##########