##########
###   ####
# $ .$####
# .$$  ###
# ## . ###
#@##. ####
#####  ###
##### ####
##########
##########