##########
# . ######
#..$@#####
#  $ #####
#.$#######
#  #######
#$ #######
#  #######
# ########
##########