##########
######## #
#   .    #
#  #  #$ #
#$####   #
#  ###  .#
# $#### ##
#.@####$ #
#    .  ##
##########