##########
#   .    #
#  $  $$ #
##  ###  #
## ###.  #
# $###  .#
# @##### #
##.#######
#  #######
##########