##########
##########
#### @####
#### $ ###
#####  # #
####  .# #
#### $#  #
####.$ $ #
## .   . #
##########