##########
######## #
#####@## #
##   $$..#
## #   $.#
####### .#
####### $#
#######  #
######## #
##########