##########
#   .  ###
# $.$ ####
####  # ##
####$ .  #
####   $ #
##### # @#
####### .#
######## #
##########