##########
#. ##### #
#$ ## # .#
#@$      #
##  # .$ #
####### .#
#######$ #
#######  #
#######  #
##########