##########
######   #
######.  #
## # ##  #
# $ ...  #
#@ # $   #
####$ ## #
#### $## #
#####    #
##########