##########
#    .####
#  $ $@###
#. # #####
#.  .#####
# ##  ####
# $  $ ###
# #    ###
# ########
##########