##########
##########
##########
##########
#.  ######
# $$$ ####
# . . ####
#$. ######
#@  ######
##########