##########
## #.$.# #
#  . $   #
#  #.  $ #
# ##  #  #
# ### ## #
####@$####
####  ####
##########
##########