##########
#      ###
# #  # ###
#  ##  ###
# $# # ###
#     $@.#
#.$..$ ###
#  #######
# ########
##########