##########
######   #
###### $ #
#######  #
#######$.#
#######  #
# ##. # @#
# $   $. #
#.    #  #
##########