##########
##  ######
#@$. #####
# $  #####
###.######
##  ######
##$  #####
#  .$#####
#      .##
##########