##########
#@########
# ########
#  #######
# #. #####
# $ $ ####
#. $.   ##
# #  $ .##
#### #   #
##########