##########
##  .    #
##       #
###. ##. #
###.#### #
##  #### #
## $     #
###@$ $$ #
#####    #
##########