##########
#  .     #
#    @   #
# .#### ##
# ####   #
#. ### $##
# #  $  .#
#   $ $ ##
#       ##
##########