##########
#######@##
##     $##
###$ .$ ##
##  ##$ ##
## .##.  #
##  ###  #
##  ### ##
#   .   ##
##########