##########
#   #    #
# $ # $. #
#   # .$ #
#@$ ##   #
##  #### #
##.##### #
# .##### #
#        #
##########