##########
#  .$@####
# $. #####
# # $ ####
# ## #####
# #  #####
#  $.#####
#    #####
# . ######
##########