##########
#######  #
######.$ #
###### $.#
###### $.#
#######  #
#######  #
###### .$#
##    @  #
##########