##########
#    #####
# $ .#####
# $####@##
#  ####$ #
#.    $ .#
#  # .   #
##########
##########
##########