##########
##########
##########
##########
##@#######
# $   ####
#. #..####
#$$.$ ####
#     ####
##########