##########
#        #
#  #  .  #
## ####$##
#   $ $  #
#.. #  .##
#@####  ##
#  ###$ ##
#        #
##########