##########
# . @ ####
#  .$ ####
# ##$#####
# #   ####
#.#   ####
# ##$ ####
# #  #####
# $ . ####
##########