##########
##########
#### #####
##   #.###
## $ . ###
##  .$  ##
######. ##
# # $ $# #
#@       #
##########