##########
######  .#
#######  #
# # $ $  #
#     .$ #
# . .### #
#######  #
###   # $#
###     @#
##########