##########
##########
##########
# ########
# @.######
# # ######
# $$ #####
# $. #   #
# $ . .  #
##########