##########
##########
##########
#   .#####
#  .## ###
#.   $ ###
# $  $ ###
##$### ###
# .@     #
##########