##########
#        #
#.. $.$  #
# .#######
## #######
##$#######
#  @######
# $#######
#  #######
##########