##########
# @     ##
#   $$$ ##
# ##  ####
# .#$ ####
#. .  ####
# .  #####
##########
##########
##########