##########
#   ######
# $#######
#. #######
#  #######
#  .. $@##
# #.$ ####
# $ ######
#   ######
##########