##########
####  ####
#### $####
####@  ###
#### $####
##  # $ ##
# $   .. #
#.   .# ##
####    ##
##########