##########
####  $. #
#####    #
######## #
# ##### .#
# ###### #
# $ .    #
#@$   $ .#
#  #######
##########