##########
#   ######
# $.######
#.########
# # ######
# $  .####
# $.  ####
#@$#######
#  #######
##########