##########
##########
##########
###@######
###$######
##  .#####
# . ######
# $$.#####
# $   .  #
##########