##########
#.     $.#
# $ $.$@ #
#####. ###
#####  ###
##########
##########
##########
##########
##########