##########
##########
## # ##  #
##   @ $ #
## $ $   #
###.   ###
###  ##  #
### . #$ #
###  ..  #
##########