##########
##########
##########
## #######
##  ######
#. $$@####
#  $ .####
# .$ #####
#. # #####
##########