##########
##       #
# .$   $ #
# . ######
# $ ######
##  ######
#  #### ##
#.$ ##@  #
#       .#
##########