##########
#   .    #
# @    $ #
# ##  # .#
#  ##   .#
#  ### #.#
# $$ $   #
#      # #
##########
##########