##########
##########
#  #######
# ## # ###
# .    $ #
#  $$ .. #
#   ######
# $.######
#@  ######
##########