##########
######.  #
#####  $ #
##### $@##
##### .$##
###### .##
######  ##
######.$ #
#       ##
##########