##########
### ######
### ######
## . #####
##$ ######
##  ######
## .######
#@$   $  #
#. $.   ##
##########