##########
#. #@ ####
#   $ ####
# $  #####
# .$.#####
# $#######
#. #######
# ########
# ########
##########