##########
##########
##########
#  #######
# .#######
#. $ #####
# $# #####
#$$@.#####
# .  #####
##########