##########
##       #
##@$   . #
####  ## #
####  .. #
#### .#$ #
##### $  #
####  #$ #
####  #  #
##########