##########
##########
# ########
#. .######
# $. #####
# $ $#####
# #   ####
#$ #. ####
#@## #####
##########