##########
#  .  @###
# $. $ ###
#. #######
#. #######
# $  #####
#  #######
# $#######
#   ######
##########