##########
# @#######
# $#######
# . ######
# $$.#####
#.$  #####
# .#######
#   ######
#   ######
##########