##########
##  .    #
## #  #  #
## ####$ #
## ###.@ #
#   # .$ #
#.    $$ #
#   #   ##
# ########
##########