##########
#      ###
# #. .#  #
# $   #  #
#@$$$##  #
#        #
# # ##.. #
##########
##########
##########