##########
#     ####
# $.  ####
#  $ #####
####  ####
# # . ####
# ## #####
#@$ .#####
# $ .#####
##########