##########
## @######
##$$ #####
##  ######
## $ #####
##   #  ##
##  ##   #
##. ##.$ #
#   ..   #
##########