##########
#    . ###
#.   $ $.#
# $      #
####### .#
#######$##
#######@##
##########
##########
##########