##########
##########
##########
######## #
##  .. $.#
###  ##  #
### $##  #
###   #$$#
## . @   #
##########