##########
##       #
##  $. $ #
##. ## ###
#    #. ##
##   #  ##
#### $@###
#### $.###
#####   ##
##########