##########
###  .   #
###    $ #
#### #####
#  # #####
# #  #####
# $.$@####
#  $.#####
# .  #####
##########