##########
##########
##########
#######@ #
#.  $  $.#
#   $ #  #
#  #### .#
# $ ###  #
#  .#### #
##########