##########
#@ #.  $ #
# $  $ . #
# $. .#  #
####  ####
##### ####
##########
##########
##########
##########