##########
#. . .   #
#.$   #  #
#  ####$ #
#  ####  #
# $##### #
##@####  #
##$####  #
##       #
##########