##########
###.######
### ######
##   #####
## $######
## .## ###
## $ # ###
## . $ # #
##   . $@#
##########