##########
#  .  ####
# $    ###
# $##.####
#  ## ####
#  ##.#@ #
# ### #  #
# $   ## #
#  .   $ #
##########