##########
##########
##########
###### @##
######$$##
###  #  .#
##  $#   #
##   # $ #
#  . . . #
##########