##########
##########
##########
#####.####
#  ## ####
# ## @.###
#  # $####
#.$$ $ ###
#   .  ###
##########