##########
#  #### @#
#   .  $ #
# .   #  #
### ######
#  $.#####
#  . #####
# $$ #####
#    #####
##########