##########
####    ##
####@$$ ##
####   ###
#### .#. #
####     #
#####$# .#
#####.#$ #
####     #
##########