##########
##########
##########
##   #####
###.$#####
# $  ### #
#   $@## #
# #$ # # #
# ..   . #
##########