##########
####    ##
###@$   .#
#. $ ##  #
#     $ ##
####   $ #
#### . # #
####  ## #
#### .   #
##########