##########
#  @   ###
# $ $.$ ##
# ####. ##
# #### ###
#  ##. ###
# ###   ##
#  ## $ ##
# .    ###
##########