##########
##  .   ##
# $  #$ ##
# $### ###
#  ##.  ##
##  #   ##
## ##  ###
#   .@$.##
#      ###
##########