##########
# .      #
#. # ##  #
#. # #####
# $$ #####
#$$ .#####
#@########
##########
##########
##########