##########
#####   ##
## @##  ##
## $   ###
###    $ #
##  #.   #
## $ # # #
##    $. #
##   ..  #
##########