##########
#       ##
#.    ####
#. #######
## #######
##.#######
## #  # ##
# $$.$ $ #
#     @  #
##########