##########
# $ .  ###
# .$$ ####
#.$   ####
#.@# #####
#  #######
##########
##########
##########
##########