##########
#.    .  #
# ## $ . #
# #   ####
#  $ #####
# # $@####
# #. #####
#  #$ ####
#     ####
##########