##########
####.    #
####$##  #
###. ##  #
### $@#  #
###  ##  #
#### ### #
## $   $ #
#  .   . #
##########