##########
###     .#
####$@#  #
#### ##$ #
#### ##..#
###   #  #
###   $$ #
###   #. #
#######  #
##########