##########
#######  #
######  ##
######$ ##
### ## . #
#   $   .#
# $  #.. #
##@### $##
#####    #
##########