##########
#@     ###
#$$$ #####
#. #######
# .#######
# ########
# .#######
#.$#######
#  #######
##########