##########
#.  .  ###
# $  $ ###
# .$######
##$ ######
##@.######
##########
##########
##########
##########