##########
##########
##########
##########
##########
# ##  ####
# $.$ #. #
#@$#  .  #
# $   .  #
##########