##########
# $  . ###
#  . $ ###
# .$ #####
###.  ####
####  ####
####  ####
### $#####
###  @   #
##########