##########
##### .  #
###  $ ..#
###   $  #
#######$.#
#######  #
########$#
########@#
##########
##########