##########
#### .   #
####$    #
# $   #@.#
#    .#  #
#.$# ##  #
#  ##### #
# $##### #
#  ##### #
##########