##########
#    #####
# $$ #####
#..#######
#.$#   ###
# .   $@##
#      ###
# ########
#   ######
##########