##########
#   ..  ##
#     $ ##
## ##### #
#  ####  #
##  #### #
#  $###  #
#.$  ##$ #
#  .    @#
##########