##########
####     #
### .. $ #
#### $  ##
### .#####
### .#####
#      ###
# $  $ ###
# @#  ####
##########