##########
######## #
######## #
#######  #
###@$.   #
#### $ . #
#######$ #
##### #  #
#.  .  $ #
##########