##########
######. ##
#  $ @  ##
##       #
######  ##
##   $ .##
###  #..##
# $$ ## ##
#       ##
##########