##########
### ### .#
#@$   $  #
### $ ...#
#####   $#
#######  #
##########
##########
##########
##########