##########
# ########
#  #######
# ########
#  #  # ##
# $.  .  #
#   $  $ #
###$##..##
###@######
##########