##########
##     ###
### .$ ###
####. ####
####.$@###
####  ####
###   ####
## $ $####
#.      ##
##########