##########
##   .  ##
## $   .##
### ### ##
###  #.  #
# $  ##. #
# $  #  ##
# $###  ##
#   @    #
##########