##########
##########
##########
#######  #
#######$ #
#### @#  #
### $ #. #
# $. #.$ #
#.       #
##########