##########
# .  @####
#.$ $ ####
#. #######
#  $ #####
#.$  #####
#  #######
# ########
# ########
##########