##########
#      .##
# $..$ ###
#### $####
#### @####
### $#####
###.   ###
###   ####
#### #####
##########