##########
#  # #####
# $$. $@##
#  $   ###
#.  ## ###
#   #  .##
### #  ###
### ##  ##
###    . #
##########