##########
# $..  ###
#.$   ####
#@$ $ ####
##. ######
##########
##########
##########
##########
##########