##########
#@   #####
#$$ ######
# #. #####
# $ ######
#   ######
#.########
#. # .$ ##
#        #
##########