##########
####  ####
##@ $ ####
## $ .####
####   ###
## ##$ ###
#.     ###
#  . $.###
#     ####
##########