##########
##      .#
## .$ $. #
##### #  #
######## #
######## #
#  @###  #
# $ $  . #
##   ##  #
##########