##########
#### $ . #
####.  $ #
### $# # #
####  #  #
###   # .#
###  ##  #
###  ## $#
### @ .  #
##########