##########
#######  #
#######$ #
####### .#
####    .#
####. @# #
## ##.#  #
# $ $  $ #
#     #  #
##########