##########
##########
##########
##########
## #######
##  . ####
# . #  ###
#. $$  $@#
# .  $ ###
##########