##########
# . ######
# $$.$@###
#   $ ####
# . ######
##  ######
## . #####
### ######
##     ###
##########