##########
# ..   $@#
#  $ . # #
## $ # # #
##$ ######
## .######
##  ######
##########
##########
##########