##########
#######  #
## ### $ #
#  $  $. #
# @## .$ #
# #####  #
# #####  #
#  # #.  #
# .      #
##########