##########
#.   #####
#    #####
#$ .######
#. #######
#   $@####
##$$ #####
##.  #####
##      ##
##########