##########
#  . #####
#  . #####
# # ######
#     ####
# .$  $@ #
##$ .$  ##
##  ######
### ######
##########