##########
#### .## #
####@$## #
#### $  .#
#### $   #
######## #
######## #
####  # .#
#     .$ #
##########