##########
####  #  #
####@ .  #
####..#  #
#####  $ #
####.  # #
####$ #  #
#### $ $ #
#####    #
##########