##########
##########
######  ##
###### $ #
###### . #
##### $$ #
#####$. ##
####.  ###
#  @ .   #
##########