##########
##.#  @  #
#    $ $ #
#. $  #  #
#.###### #
# ########
# ### ####
# .  $ ###
#      ###
##########