##########
####     #
##### .$ #
##### $#.#
####.  # #
####  #  #
####  ##$#
##### $ .#
#### @   #
##########