##########
####     #
#### $ . #
#####. ###
####  ####
#  $ $ ###
#. .$@####
##########
##########
##########