##########
# . $   .#
#@$$.. $ #
#   #### #
#######  #
#######  #
######## #
#######  #
#####    #
##########