##########
##########
###.  ####
## . $@###
## $ $$###
#####   ##
######  ##
##### .  #
#    .   #
##########