##########
#  #######
# $ ######
#   ######
#  #### @#
# $ ###$.#
#  # ##  #
#.    $  #
#  #  .. #
##########