##########
### .   ##
####     #
#### ##. #
## # # $##
#      $@#
#.  $ $###
# ## .  ##
##########
##########