##########
# .      #
# # $  $$#
#  #### .#
# #####. #
# #####  #
#  @ .####
# $   ####
#      ###
##########