##########
### ######
##  .#####
## $  ####
###. #####
###  #####
### $@####
###.$$ ###
#    . ###
##########