##########
##########
##########
##   ## ##
###$    .#
###@$ #$ #
##  .# . #
##  ## $ #
### .    #
##########