##########
# $  . . #
#@$  $.$ #
######   #
####### .#
##########
##########
##########
##########
##########