##########
##########
#@$  .   #
## .$  $.#
##  #### #
## ##### #
## ##### #
#   $ ####
#.     ###
##########