##########
##########
##########
#  #######
#    #####
# #$$.####
#@# . ####
# #$ $####
#  . .####
##########