##########
##########
##########
##########
##########
#####@####
###  $ . #
## $$..  #
#   .  $ #
##########