##########
##########
##########
#  #######
# $ ######
#.   .####
# #.$.####
## $$ ####
#   @   ##
##########