##########
##########
######## #
###      #
##  ## $ #
# .$### .#
#    $@$ #
#. .# ## #
##########
##########