##########
#        #
# $$@##  #
#  ####..#
## ####  #
# $$ .   #
#  . #   #
# ###### #
##########
##########