##########
#####  ###
#####$. ##
# ###  ###
#   .   ##
#.  # . ##
# $##$  ##
#  ## $###
# ####@###
##########