##########
##########
##########
#.  ######
#. $ #####
#    #####
#.#$$#####
# #   $ ##
#  .   @ #
##########