##########
##########
##########
# ########
#.########
#  #######
#. ### ###
#$$ $  $ #
# . . @  #
##########