##########
# ########
#  #######
#.$ $  $ #
# $.     #
# ###### #
# ##### @#
#. ####  #
#       .#
##########