##########
#   @# .##
# .$$    #
# $  $   #
#####..###
######  ##
###### ###
##########
##########
##########