##########
##########
##########
##########
###### @##
#######$ #
######   #
# .$ $ $ #
#.   . .##
##########