##########
####.    #
#######. #
####### @#
######   #
######$$ #
###### $ #
##### $. #
#####  . #
##########