##########
##########
#######  #
##.      #
##$$$##. #
## . ### #
##. ### @#
## $###  #
#        #
##########