##########
#@  ######
#$$#######
#  #######
# .$ #####
#.  .#####
# $ ######
# .#######
#  #######
##########