##########
##########
##########
#######  #
####  #$@#
#### $#  #
####. #  #
### .. $ #
### .  $ #
##########