##########
##########
# ########
#. #######
#     ## #
# ..$. $ #
#  ##  $ #
# #####$ #
# @      #
##########