##########
# #@  ####
#.  $ ####
#  $  ####
# #  #####
# ########
#   .   ##
# $. $ ###
#.  ######
##########