##########
######## #
###  ..  #
####$ #. #
#### ##$ #
####  #  #
#### ##  #
#  #.$ $ #
#  @     #
##########