##########
######   #
######$$@#
##### ..##
#####  .##
######$$##
#####   ##
###.     #
##       #
##########