##########
# .     ##
#       ##
#. ### ###
#     .$ #
# #  #$$ #
######   #
#######$@#
######  .#
##########