##########
##########
####### @#
###### $##
#####.$ ##
#####  . #
#####  $.#
#### # .$#
#        #
##########