##########
#  .######
# .  #####
#  $ #####
#.$# #####
# .# #####
# $ $ ####
#  #@ ####
##########
##########