##########
##########
#######  #
#.#    $ #
#    .   #
#@$#     #
#  ##### #
#$$.# #  #
#    .   #
##########