##########
#.  @ ####
#$$$ .####
#  #######
#. #######
#   ######
#  #######
#.$ ######
#  #######
##########