##########
######   #
######$$ #
######   #
####  $  #
####   ###
####  . ##
####@$..##
### .   ##
##########