##########
####### @#
###### $.#
####### $#
######.. #
###### $ #
###### $.#
######  ##
######  ##
##########