##########
##########
##########
##########
###@######
###$ . ###
## .$. ###
# $ .$####
#      ###
##########