##########
# # #@$. #
#  . $ $ #
# $  ..  #
##########
##########
##########
##########
##########
##########