##########
#######@ #
#######$ #
##### $  #
#### $ . #
####  ##.#
## #   #.#
# $      #
#   .    #
##########