##########
###. ### #
###$.    #
### .#   #
#### ##  #
#@$ $ #  #
# $   ## #
#  #######
# . ######
##########