##########
#  #######
# ########
#@####   #
#  #  $ ##
# $##   ##
#  #..####
# $  . $ #
###  .   #
##########