##########
##########
##########
#     ####
##$$ #####
#.  .@####
#  #. ####
#$$#  ####
#    .####
##########