##########
#        #
#   . $. #
# #### ###
#. #   ###
#    # ###
#    #$$ #
#####@$  #
######  .#
##########