##########
#   .#####
#   ######
#. #######
#  .######
##$#######
#   ## ###
#.$$  $ ##
#@      ##
##########