##########
## .  .  #
## $  $  #
#####. $##
###### .##
######  ##
###### ###
##### $ ##
##### @ ##
##########