##########
# $   .. #
#@$ $  $ #
#### #####
####. ####
####  ####
###  .####
###   ####
#### #####
##########