##########
#  $. ####
#   $@####
# $#######
#$.#######
# ########
#  #######
#.# ######
#.  ######
##########