##########
##########
##########
## #######
# .#######
# $# #####
#  $   $@#
#.$  . ###
# .  #####
##########