+ + + + + + + + + +
+ - X X + - - + + +
+ - X X + - @ + + +
+ - - + + - - - - +
+ + - @ - - - @ - +
+ + - + + - - + + +
+ + - - - @ + + + +
+ + + + - - + + + +
+ + + + * - + + + +
+ + + + + + + + + +