+ + + + + + + + +
+ * - - - + - X +
+ - - @ @ X - - +
+ - - - - - - - +
+ + + + + + - - +
+ + + + + + + + +