+ + + + + + +
+ - - - + + +
+ - - - - - +
+ - + - + - +
+ - + - + - +
+ % @ - + - +
+ - - - - - +
+ + + + + + +