+ + + + + +
+ + + - - +
+ + + - - +
+ % $ @ - +
+ - - - + +
+ + + + + +