+ + + + + + + + + +
+ + - + + + + - - +
+ + - @ - - - - - +
+ + - + + + - - - +
+ + - - - + - + + +
+ - - - - - - * - +
+ - - - + - - + - +
+ X + + + + - - - +
+ + + + + + + + + +