+ + + + + + + + + +
+ + + X + - - - X +
+ - @ - X X - @ - +
+ * @ - - - - @ + +
+ + + + + + - - + +
+ + + + + + + + + +