+ + + + + + + +
+ - - - - X * +
+ @ @ + @ @ + +
+ - - + - - + +
+ - - + X + + +
+ - - - + + + +
+ - - - X - + +
+ X - + + + + +
+ + + + + + + +