+ + + + + + + +
+ + + - - - - +
+ + + + - @ - +
+ + + + - - X +
+ + - @ - X - +
+ - - - @ X - +
+ - - + - - X +
+ + + + - @ - +
+ + + + - - * +
+ + + + + + + +