+ + + + + +
+ + + + - +
+ + + - - +
+ + + @ - +
+ + + - - +
+ + X - X +
+ + - @ X +
+ - - + @ +
+ X - @ * +
+ + + + + +