##########
##########
##########
##########
### #@####
# .. $   #
#      $.#
#. ## $$ #
#  ####  #
##########