##########
##########
##########
# ##  .  #
#.$ .    #
#  ## # @#
#. ####  #
#$$####$ #
#        #
##########