##########
#.  ..   #
# $ #  # #
#@#  #   #
##   #   #
##  ###.##
###  # $##
## $ $   #
##      ##
##########