##########
#     ####
# .# . ###
# .## @###
#  $  ####
#  $$ ####
#   ######
# .$######
#   ######
##########