##########
#######  #
#######$ #
####### @#
#######$.#
####### $#
#    .#  #
# $   #  #
###  . . #
##########