##########
##########
##########
##########
##########
#    #####
#$$. #####
#.$.$@####
#  . #####
##########