##########
#    . . #
# $   $  #
#### #####
#### ##  #
###     .#
###@$  $ #
#######. #
#######  #
##########