##########
#.       #
#.# $  . #
#  ###   #
#$    # ##
#@$.$ ####
####  ####
##########
##########
##########