##########
#       ##
# $  $ $ #
#        #
##$##### #
#.   ..@ #
#     .  #
##########
##########
##########