##########
##########
##########
##########
##########
#@    ####
#.$ $$ # #
####$..  #
###    . #
##########