##########
##########
######. @#
###### .$#
###### $ #
###### $ #
#######$ #
######  .#
####    .#
##########