##########
# .  $   #
#  $ #   #
# ########
# .  #####
#.# . ####
###  #####
###$$#####
#    @   #
##########