##########
# ###  # #
# $.    .#
# . #    #
#  ##### #
#   #### #
##$$ ### #
##@$ ##  #
###  .   #
##########