##########
#######  #
###### .##
######$  #
### $ .  #
### $ #  #
### @#  ##
###   #$ #
### .  . #
##########