##########
#.########
#  #######
# #### ###
#  ### ###
# $## .###
# $  . ###
# ##$  ###
# . @$   #
##########