##########
#   ######
#.$  #####
#.    ####
#     ####
#### #####
####  ## #
### $$ $@#
###   .. #
##########