##########
#. #######
#  #  # ##
#     .$ #
# $$  .$@#
#. ## ####
##########
##########
##########
##########