##########
##########
##########
######@ ##
#### $$$ #
####   . #
#  .  ## #
#. $ ### #
# .      #
##########