##########
#  .   $ #
# $$$ ## #
# .  .#@ #
#. ####  #
#  ##### #
######## #
##########
##########
##########