##########
###    . #
### .$ $ #
###   #$ #
#   @## .#
# ## ##  #
# ########
#  #######
# $. #####
##########