##########
##########
#.  ######
# $  . ###
#   #   ##
# .## $ ##
#  ##   ##
#   #$ $@#
#  .#   ##
##########