##########
##########
##########
### .#####
#### #####
#     ####
# . $$####
##$#@$  ##
# .  .   #
##########