##########
######.  #
######@$ #
######  ##
#    # $##
#    #$  #
#  $##   #
# .  ##  #
#    . . #
##########