##########
##########
##########
##########
###### . #
#  ####$ #
# $####@ #
#.  ##.$ #
#.     $ #
##########