##########
##########
##########
## @######
###$ #####
## .$#####
##$  #####
#.$ . #  #
#    .   #
##########