##########
##########
##########
##########
##@.######
##$$ #####
##  $#####
# .$ # ###
#  .  .  #
##########