##########
# # ######
#   ######
# $ ######
# .$@#####
# $ ######
#  #######
#.$#######
#  .  . ##
##########