##########
# @      #
# $.$ .. #
# # $   ##
###### ###
#####   ##
######$ ##
##### . ##
#####   ##
##########