##########
#######. #
#######  #
#######$ #
#######. #
# @####  #
# $$ $   #
# .  # .##
#### #####
##########