##########
#.  $@####
#  $ .####
# $#######
#  #######
# ########
#.#####  #
#  ####$ #
#.       #
##########