##########
########@#
####### $#
#######  #
######## #
####### .#
#####  $ #
#### . $ #
####  $..#
##########