##########
#       ##
# $ . ####
# # $#####
### $ ####
###.$ ####
#### .####
### .#####
###  @####
##########