##########
####.  .##
#  #$.$ .#
# $    $ #
#  #  # ##
# ########
#  #######
#  #######
# @  #####
##########