##########
#@    .  #
# .$.$ $.#
#  ####  #
# #####$ #
######   #
##########
##########
##########
##########