##########
#   .@ ###
# $   . ##
#  ### $##
# #### .##
# #   .###
# #    ###
# $$ #####
#      ###
##########