##########
#######  #
#######$ #
######   #
#  $     #
#@$    . #
##### #. #
##  .. $##
##      ##
##########