##########
##########
#.  ######
# . ######
# $ ######
##$ ######
#    $ ###
#. $ #@###
#  . #####
##########