##########
# ..    ##
#.  $ $ ##
#  #######
# ########
#  #######
# #  #####
#.$ $ ####
#     @  #
##########