##########
#    #####
# .$ #####
# $#######
#. #######
# ########
# . ######
#@$ $ . ##
#       ##
##########