##########
# .   ####
# $ $  ###
#@##.$.$ #
#  #   . #
# ########
##########
##########
##########
##########