##########
###     .#
##   $ $ #
##.   . .#
###$  ## #
###  ### #
#@$  #####
#   ######
##########
##########