##########
###   .  #
###$  #  #
#@$  ## .#
##  . $$ #
## .  #  #
######## #
#######  #
#######  #
##########