##########
#  .  .$@#
# $ .. $ #
### $##  #
###  #####
##########
##########
##########
##########
##########