##########
###  @ . #
### .$$$ #
#####.. ##
#####  $##
######  ##
##########
##########
##########
##########