##########
#  .     #
#.  $ $ ##
# $.######
# .#######
#$########
#@########
##########
##########
##########