##########
##########
##########
##########
# # ######
#..  #####
# $.    .#
# # $$$ ##
####@ ####
##########