##########
##########
####   ###
####.$ ###
#####$@###
#####  ###
#####$.###
#  # $. ##
#      . #
##########