##########
##### # ##
#####    #
#####.  .#
## # .#  #
# $    $ #
#   #.#  #
# $$###@ #
#   ###  #
##########