##########
# . # ####
# $$ .$ ##
# $.  . ##
#  #######
# ########
#@########
#  #######
#   ######
##########