##########
##########
##########
##########
# #### ###
#    .   #
# $.$ $  #
#  $ # ..#
# #@######
##########