##########
##########
##########
##########
##########
# ###   ##
#  $@$. ##
#.$ # $###
#.  .  ###
##########