##########
# @#######
#$$####  #
#. ####  #
#  ## ## #
# $ .    #
#. # $ . #
# #####  #
######   #
##########