##########
### .  ###
### .  ###
###  # ###
####@#  ##
### $  ###
## #. #. #
## $ $ $ #
##       #
##########