##########
#    #####
#  $$#####
#$ # #####
# ##.#####
#@##  ####
# #   ####
#.#  #####
# $. .####
##########