##########
# ########
# ########
#  ##  ###
# $##$ ###
#@  $.. ##
# $ #   ##
# .### ###
# .#######
##########