##########
#  .@.   #
#  #  $. #
#  ## $$ #
# $####. #
#   ######
# ########
##########
##########
##########