##########
#####    #
####  #..#
###.$.$  #
###      #
###  #####
####  ####
## $$#####
#  @  ####
##########