##########
#  #######
# ########
#  ####  #
# $##    #
#. #    .#
# ..$$####
#@$   ####
#  #######
##########