##########
####### .#
###### $ #
####### @#
#######$ #
#######  #
#######. #
#### . $ #
####  .$ #
##########