##########
####    ##
#####.$ @#
#####  $ #
#####.$.##
######  ##
###### # #
#####  $ #
##   .   #
##########