##########
##########
###  #####
### $##  #
### @ # .#
####$### #
###  ##  #
###. $ $ #
###    ..#
##########