##########
## ##  . #
#. $   $ #
# @## #. #
##### ##.#
####     #
#### $$  #
#####    #
##########
##########