##########
#### . . #
#### $.  #
####### ##
#######  #
######  ##
####@$   #
##### $$ #
###.     #
##########