##########
######   #
#######$ #
#######  #
#######$ #
#####@#. #
#####$#  #
#### .$ .#
####    .#
##########