##########
##########
##########
# ########
#.########
#   ######
#@$$.#####
#$    ####
# .$. ####
##########