##########
#  ##### #
#.     $.#
#. #  .$@#
#  ####  #
# $####$ #
#  ####  #
######## #
#######  #
##########