##########
#@###    #
#$ ## $$ #
# $###   #
#   ###..#
#    .   #
#   # #  #
# ########
#.########
##########