##########
####@ .  #
#### $  ##
###### ###
# $ .    #
# .   $  #
##### $  #
######  .#
##########
##########