##########
### .   .#
#### $.$ #
###### . #
#######  #
#######$ #
####### $#
########@#
##########
##########