##########
##########
##########
##########
###   ####
### $ ####
#@$   .  #
#####.$  #
#    ..$ #
##########