##########
#### .# ##
####.   ##
####     #
#### #   #
###@$.#$ #
####   $ #
######$. #
#####    #
##########