##########
##  @ ####
## $$ ####
###$ #####
###  #####
#### ### #
###  $ # #
###   . .#
###   .. #
##########