##########
##########
### ######
#.  . . ##
# $  #  ##
### ######
##  $@#  #
## $ $  .#
##       #
##########