##########
#     ## #
# $ . #  #
# ##..## #
#### ##  #
#### . $ #
####   $@#
#######$ #
#######  #
##########