##########
#####@####
#####$ ###
###   ####
# $$  ####
# $   ####
# ###  ###
# ##   ###
#.  ...###
##########