##########
# #    ###
#.$ .$####
#      ###
# ###  ###
# ##   ###
# ###.####
#  # $####
#.   $@###
##########