##########
#        #
#.$ .  .##
# . $ ####
# #$$#####
### @#####
##########
##########
##########
##########