##########
#  #######
#  #  ####
#..$$. ###
#   $@####
# .$######
#   ######
# ########
# ########
##########