##########
# ########
# ########
#  #######
#.$#######
#  #  ####
# .$. ####
#$$   .###
#@ #  ####
##########