##########
# @#######
#$$.######
# .  #####
#  .######
#.$$######
#   ######
# # ######
##########
##########