##########
## ##    #
#        #
##  # $  #
####### .#
###### #.#
#@$ .    #
### $ $  #
#######. #
##########