##########
#  #.##  #
# $ $ $  #
#    .#@ #
# ##### ##
# .   $ .#
###   ####
##########
##########
##########