##########
########.#
######## #
###### # #
###.   $.#
###  $ $ #
### #### #
# $.     #
#   #   @#
##########