##########
##########
##########
###### @##
#######$ #
######   #
#### $$  #
####. .$ #
##### .. #
##########