##########
#    #####
# . $ ####
#  #. ####
#   .#####
# #$$#####
# #@  ####
# #.$#####
#     ####
##########