##########
#### $  .#
####@$  .#
#######  #
#######$ #
#######  #
####### .#
#######$.#
#######  #
##########