##########
#   .###.#
# $  ### #
# ##  ## #
# ## ##  #
###   #  #
###. ### #
# $$$ .  #
#  @     #
##########