##########
#    #####
# .$######
#.@ ######
#$$ ######
#  $ #   #
# #  ##  #
#.#. ### #
###      #
##########