##########
# @.$ ####
#   . ####
# ##. ####
# $   ####
# $#  .###
#   ######
# $#######
#  #######
##########