##########
###### . #
###### $.#
##@  ##. #
##   #  ##
##   # $ #
##   # $ #
##  ## $ #
#    .   #
##########