##########
# .   $@ #
# #  .. ##
# ##   ###
# $  #####
#  $ #####
#.$# #####
#  #######
##########
##########