##########
##########
##########
#####@####
### .$####
####$ ## #
####  #  #
####.$ $ #
# .   .  #
##########