##########
#     .  #
#   # .$ #
#  #### .#
# $ ###  #
##@ ###$ #
####### .#
#######$ #
#######  #
##########