##########
#### .   #
####     #
## ..  $.#
#@$  ##  #
# $$ #####
##   #####
##########
##########
##########