##########
##  @. ###
## # $$###
## ## .###
#  ###. ##
## $  .###
##  #  ###
##### $  #
#####    #
##########