##########
##  ######
## . #####
##.  #####
# $$#  ###
# #  .####
# ###@.  #
#  ## $$ #
#        #
##########