##########
#####  ###
#.## $  .#
# ##@$   #
#  ##### #
# ###### #
# ### ##.#
#      $ #
#  ##  $.#
##########