##########
### ######
#  .######
#. $@#####
#$  ######
#  $######
#.#  #####
# ##   ###
# $   . ##
##########