##########
##########
##########
##########
##########
##########
#    #@  #
#.$$.  $ #
# $  .  .#
##########