##########
##########
#. @#### #
# $$ .   #
##   # # #
#.$$###  #
#.   ### #
#  ####  #
##########
##########