##########
#####  ..#
##### $$ #
#######  #
###@$   .#
#### $.  #
##########
##########
##########
##########