##########
#      ###
#. $    ##
#. #   ###
####  $ ##
#  #.   ##
# $  $  ##
# @#    ##
#  ## .###
##########