##########
#   .  ###
# $#$ ####
# .$@#####
#  #$#####
# #  #####
#.## #####
#     ####
#.     ###
##########