##########
###@$  . #
####.$.  #
##### $  #
#######$ #
####### .#
######## #
##########
##########
##########