##########
#### $ . #
####@$ . #
#######  #
#######$ #
#######..#
#######  #
#######$ #
######   #
##########