##########
##       #
#.$$  .. #
#@$  ### #
## $###  #
##       #
#### .   #
###### ###
##########
##########