##########
#      ###
# $  $ .##
# .  $####
# .##   ##
# .  $  ##
#  #  @ ##
##########
##########
##########