##########
####### .#
######.$ #
######.  #
######  ##
#######$@#
######   #
#### $ $ #
#### .   #
##########