##########
#.@#######
#  #######
# $    ###
#  #$ $###
####    ##
###   $. #
#. .     #
##    ####
##########