##########
# ########
# ##@#####
#  #$. . #
# # .$   #
#  # $# ##
#  #   ###
# # .$ ###
#      ###
##########