##########
##########
##########
# @#######
#$$.######
#.$ # ####
# #   ####
# . $. ###
#     ####
##########