##########
#  #######
#  .######
#  #######
#        #
#  .## $ #
#  ####  #
# $### $ #
##@$  .. #
##########