##########
#   ##@###
# .. $ ###
#  $ $ ###
#.$.######
# ########
#  #######
# ########
# ########
##########