##########
#        #
#@ $.$ $.#
# ########
#  #######
#.       #
#      $ #
# ########
#.########
##########