##########
####   @ #
##### $$ #
##       #
#.$   .###
#  $######
#  .######
#   ######
# .  #####
##########