##########
#        #
#    $ ###
#  #######
# ########
#.########
#  .   $@#
#  . $ $ #
# .  #####
##########