##########
####  @  #
#### $$$##
######  ##
######  ##
######  ##
####.  .##
#### $#  #
##    . .#
##########