##########
###@$..  #
# #$$   .#
# #  ### #
# $   #  #
# #  .#  #
# #####  #
#        #
#        #
##########