##########
#  #######
# ########
#  #######
# $   ####
#.$.######
#  #######
#   $.# @#
#  .   $ #
##########