##########
###     ##
### . $ ##
####$##  #
#.## ##. #
#  . #  @#
#  $ #   #
# $##    #
#        #
##########