##########
#######  #
#######$ #
######  .#
###### $.#
# @ ###  #
#  $    .#
# $    . #
##   #####
##########