##########
### ######
###      #
###  ..$ #
#######$ #
##@ ###  #
###$ ##  #
##   ##$ #
##    . .#
##########