##########
##########
##########
#####  ###
##### $@##
##### .###
#####$$ ##
## #. .$ #
#.       #
##########