##########
##########
####   ###
## #$ ####
# $   ####
#.    #  #
###.$##$@#
##   ##  #
###. .   #
##########