##########
####@#####
#   $ ####
##$ . ####
## #######
#  #######
#  #######
#     $ ##
#.$.   . #
##########