##########
# #### @##
# #### $ #
#  ####. #
# ##### ##
# ####  ##
#  # #$ ##
# $ ..$  #
#     .  #
##########