##########
#        #
#      $ #
#  #######
# ########
#  #######
#.$ .#####
# $$@#####
# . .#####
##########