##########
#.  ######
# #  #####
#  $######
#.$ ### ##
#    $. ##
# #   $@##
#  .######
# # ######
##########