##########
##########
##########
##########
##########
#@ #######
#. $  ####
# $ .$####
# $.   . #
##########