##########
#       ##
# . $ # ##
# #### . #
# ####$$##
# #### .##
#  ###   #
# # ## $##
#@     . #
##########