##########
#   @    #
#     $  #
#  .##. ##
# . ### ##
#   ###  #
#  ##  . #
# $ # $$##
#  ##   ##
##########