##########
#### @.$ #
##### $  #
######.  #
#######$ #
#####  . #
#######$.#
#######  #
######## #
##########