##########
#        #
#@ ..$$ .#
###   $$ #
####### .#
######## #
######## #
#######  #
#######  #
##########