##########
# .   . ##
# $ $ $ ##
# $###@. #
# .#######
# ########
# ########
#  ##  ###
#      ###
##########