##########
#  # #####
# .  $@###
#  $. ####
#  #######
#. #######
# ########
# $ ######
# $ . ####
##########