##########
#  #######
#.$##### #
#.     $ #
#   $.# @#
# $#######
# .#######
#  #######
#   ######
##########