##########
# @ ######
#$. ######
# $.######
#  $ #####
# #  #####
#.$.######
#   ######
# ########
##########