##########
#  #######
# $ ######
#@   #####
#.$ ######
# .#######
#  ####. #
#   $  $ #
#  #  .  #
##########