##########
##########
##########
##########
#@$ . ####
#$  $ ####
#.$## ####
#.  . #  #
#        #
##########