##########
#####    #
##### . $#
##### .$ #
##  ### .#
#   ###$ #
#@ ####  #
# ### #$.#
#        #
##########