##########
#..  #####
# $ $#####
# $# #####
# .  . $@#
#  #    ##
# ########
##########
##########
##########