##########
#       @#
# $ # $  #
##  ## $ #
##  ###  #
## . ##  #
###  #. ##
###  #   #
####  .$.#
##########