##########
##########
## # .####
#  $$ ####
# .   ####
#.$#######
#   ######
#  $@#####
# . ######
##########