##########
######   #
####### .#
######## #
#######  #
##### $$ #
##### $  #
#####  $.#
#.    .@##
##########