##########
# #  ## ##
# $ . $@##
#   . $ ##
# $###  ##
#  #######
# .# #####
# .  #####
#  # #####
##########