##########
##########
#@########
#$ #######
# $### ###
#  $.# ###
#       ##
# ##.$ # #
#..      #
##########