##########
######## #
#######  #
##### $ .#
#####@$  #
######## #
#######  #
# $   $. #
#   .   .#
##########