##########
###      #
### .##  #
####  ## #
###  ### #
###$$##@ #
### .##$ #
# # $##  #
#. .     #
##########