##########
######  @#
######.$$#
#######. #
#######$.#
###### . #
######   #
###### $ #
#######  #
##########