##########
#  #######
# ########
# ########
# ########
# # ##   #
# $@$  $ #
# . $.. ##
###  ##.##
##########