##########
## .     #
### .  $ #
####.$####
####$  ###
####. ####
#### $ ###
#####@####
##########
##########