##########
##### # ##
# $  .   #
# # . .$ #
#@ ####  #
# #####$.#
#  ####  #
# ######$#
#        #
##########