##########
#  .  ####
# $.$ ####
# #$######
# # ######
# #  #####
# ..######
#  $@#####
#   ######
##########