##########
# ########
#. #######
# $#######
#.  . ####
# $ $ ####
#@ #######
#.$ ######
#        #
##########