##########
#.       #
#   .$   #
#  #### ##
##  ###  #
#@$###.$##
#  ###  ##
#####  $ #
###    . #
##########