##########
#@   #####
#$$ ######
#. #######
# $#######
# .. #####
#.  ######
# $ ######
#  #######
##########