##########
# $ .    #
# $ ## $ #
#.@ ### .#
# #####  #
###### . #
######   #
###### $ #
#######  #
##########