##########
##########
##########
##########
##########
# .#######
#  $ $ ###
#.$$.. ###
#    @ ###
##########