##########
#  #######
# .  # ###
#..$  . ##
# $$ $ ###
#  #######
#@########
##########
##########
##########