##########
#        #
#  $ #   #
# #####  #
# .  ##  #
#   ###  #
# $$.#####
# .$@#####
#.  ######
##########