##########
##########
##########
##########
# ..######
#    #####
#. $ #####
#$$$######
#@. ######
##########