##########
# $..   .#
# $# $   #
#  ##.$  #
# ###### #
#@ #######
##########
##########
##########
##########