##########
#  .   $@#
# $ $..$ #
# #  ## ##
#  .######
# ########
# ########
# ########
##########
##########