##########
#    ### #
#   #### #
# .   $.@#
#  .# $$ #
#######. #
#######  #
#######$ #
#######  #
##########