##########
##########
######@###
####  $###
#####.  .#
#####.$$ #
##### $. #
#######  #
######   #
##########