##########
#  #######
# .  #####
# # . ####
###  $####
###  $@###
#### $####
##  ..$ ##
###      #
##########