##########
# $   .. #
#  $ # $ #
# . #### #
#  ##### #
#   ###  #
## #### .#
##$ ####@#
##       #
##########