##########
####.  . #
#####  $ #
## @## ###
# $### ###
#  ##   ##
#  ##  ###
#  . .$$ #
#        #
##########