##########
# .  @ $ #
# $ $.$..#
#####    #
##########
##########
##########
##########
##########
##########