##########
##.      #
#. # .   #
#  #### ##
#     $ ##
# $$. $@##
#  #######
# ########
# ########
##########