##########
#@ #######
##$  #####
#   ######
# $ ######
# .  ## ##
# $ ### .#
#   ## $ #
# .    . #
##########