##########
# .    . #
#$$ .$ $ #
# #####@ #
#  ##### #
#  ####  #
#. ##### #
# ###### #
##########
##########