##########
###. $  .#
###   $  #
######## #
#######  #
#### @# .#
#### $  .#
#### $   #
####  #  #
##########