##########
#  #######
#.   ..###
# # # @###
#  ##  ###
# . $ $  #
##  #  $ #
#######$ #
#######  #
##########