##########
#  . $@###
#   $$####
##### #  #
####  ## #
####.  # #
####  ##.#
####     #
### .  $ #
##########