##########
##########
##########
##########
##########
##########
####@#  .#
# . $$ $ #
# $   .. #
##########