##########
#  #######
# $.######
# $#######
#. #######
#@$ ######
# .$  ####
# #. #####
##########
##########