##########
#       ##
# $@$#   #
# $# ##  #
#  . #  ##
###  ##.##
#### # . #
### $   ##
###  .  ##
##########