##########
### @    #
### $ $. #
#######$.#
####### .#
#######. #
#######  #
####### $#
#######  #
##########