##########
#######  #
### #  $.#
### $ .. #
###   $$ #
#  .##@ ##
#   ### ##
#    #####
##   #####
##########