##########
##########
##### # .#
## $ $   #
##     . #
######## #
######## #
##   # $ #
#@$    ..#
##########