##########
# .$@$.###
#   $  ###
# ########
# ########
#  #######
# ########
#  #######
#. $  .  #
##########