##########
#@.$  ####
#$$.  ####
# $. #####
#.#  #####
#  #######
# ########
#  # #####
#    #####
##########