##########
##    .@##
## $.$ ###
####$  ###
####.  ###
####$.####
####  ####
##########
##########
##########