##########
#     ####
#      $ #
# .. # $ #
######  .#
#####   ##
######$ ##
#####. $##
#######@##
##########