##########
### @ ####
####$$####
###    ###
###$#. ###
###   .###
###.#  ###
#  . $####
#       ##
##########