##########
##########
##########
##########
##########
#####  ###
# $   ..##
#@$#$.  ##
# .   $ ##
##########