##########
##########
##########
##########
# #### @##
# ####.  #
# .###$ ##
# $$  $ ##
#   . .  #
##########