##########
##########
##########
#        #
#  $  # .#
### ### .#
#.  $ $  #
### #@$  #
###### . #
##########