##########
##########
######@  #
######$ ##
#####  ###
#### $ ###
### $. ###
##  . .$ #
## .     #
##########