##########
#       .#
#  ## $  #
# ###### #
# ###### #
# #####  #
# ### .$ #
#### $ . #
####@. $ #
##########