##########
#     #  #
# $$ ##$ #
# $.. . .#
#   # #@ #
##########
##########
##########
##########
##########