##########
######## #
#######  #
#######  #
###### $.#
######.  #
#####  #$#
###@$. $.#
####     #
##########