##########
##########
##########
##. ######
# $.######
# $$@#####
#  $ #####
# ..######
#  #######
##########