##########
#  #######
# $  #####
# $ @ ####
# # .$   #
#  ## #..#
# $      #
#   #  . #
##########
##########