##########
##########
####### @#
#######$ #
#######  #
###.###$ #
#   ###. #
# $ ###$ #
# ..     #
##########