##########
#  #######
# $#######
#.. ######
# . ######
#.$ ######
#  #######
#$$ ######
#@  ######
##########