##########
######## #
#######  #
### $ $  #
###  ... #
### $#  .#
####@##$ #
#######  #
######## #
##########