##########
###      #
### $    #
#######..#
######## #
###### # #
# $   . .#
# $   $  #
# @# #####
##########