##########
######   #
##### $  #
# ####@ ##
# ###    #
#  #.    #
# $ $### #
#  .$ #  #
###.  .  #
##########