##########
####.#####
###   ####
# #@$ ####
# #$ #####
# $   ####
#  #  ####
#.$   ####
#.  . ####
##########