##########
##########
##########
##########
##########
#### #@ ##
#### $$$ #
### $ .. #
#   ..   #
##########