##########
# @#######
#$$##### #
#  ##### #
#..####  #
# #### $ #
#  ### . #
# $####  #
#   .    #
##########