##########
##########
##########
##########
#####    #
#@  # $. #
# $## .  #
#   ##$$ #
#   ..   #
##########