##########
##  ######
## $.#####
#  #######
#  #######
#.########
# #### ###
#      $ #
#. $.  $@#
##########