##########
##########
#   ######
#  #######
# ####  ##
#.  $. $@#
# $ .  $ #
# ##### .#
#  ###   #
##########