##########
#.   .  @#
# $ $.$$.#
#  #  #  #
##########
##########
##########
##########
##########
##########