##########
##    .  #
## $.$   #
##  ###  #
##.  ### #
###$####.#
###@#### #
## $ ##  #
##       #
##########