##########
####  ####
#### $ ###
####@  ###
####   ###
## # $ ###
## $  # ##
#     .$ #
#  #. .. #
##########