##########
###@  .  #
##### $  #
####### .#
#####    #
#######$ #
####### .#
#######$ #
#####. $ #
##########