##########
#   ######
#   # ####
#    .$@##
# ..$ ####
#   ######
# $$ #####
# #  #####
#  .######
##########