##########
####@$ . #
##### $  #
#######$ #
####### .#
####### .#
#######  #
#######.$#
#######  #
##########