##########
##########
#### @####
### $#####
###  #####
### .  ###
####.$#  #
## .$  $ #
###     .#
##########