##########
#  @ .####
### .#####
## .  ####
# $ $ ####
#.$ ######
#   ######
# $#  ####
#     ####
##########