##########
#    #####
# $.@#####
# $ ######
##  ######
##$..#####
## .######
##$  #####
##  ######
##########