##########
# .$ #####
#    $@###
# .$ #####
#  #######
#.$#######
#. #######
##########
##########
##########