##########
###      #
###.     #
######   #
#######  #
#  .  . ##
#  $ #   #
### $ #$##
### .  $@#
##########