##########
###  #   #
### $#  .#
###. #   #
###   #  #
### $##  #
### .## .#
### $$   #
###   @  #
##########