##########
##########
####   ###
#  $  ## #
#       .#
#.#.##$#.#
# ## @ $ #
#  # $   #
#     ####
##########