##########
##########
## ## ####
#@$ . ####
#. $ $####
####  ####
####$..###
## #  # ##
#        #
##########