##########
##@#######
# $ ######
#   ######
## .######
# $ ######
#  #######
# $ # ####
#..$  . ##
##########