##########
###### ###
## ## @###
#. $  $ ##
#  $ #  .#
## ###  ##
## ###  ##
#   # $  #
##    .. #
##########