##########
######  ##
#######  #
###  . $ #
###.  .  #
####@# . #
###  $  ##
####$$# ##
###      #
##########