##########
######## #
#####    #
#.$@$    #
#  # . . #
# ###### #
# ## ### #
#      $ #
#  #  .$ #
##########