##########
#     ####
#    ### #
#.@ .### #
# $    $ #
#..#   $ #
###  ### #
###  $   #
####     #
##########