##########
#   . $ ##
#    #$ ##
# #### @##
# ### $###
# ###  ###
# ####  ##
# ###. $ #
#    . . #
##########