##########
#######  #
# #####$ #
#. ####  #
# $$     #
#. # #.. #
#@ ####  #
# $####  #
#  ##### #
##########