##########
####     #
####  $ .#
#######. #
######## #
######  .#
######$  #
###### $$#
######.@ #
##########