##########
##########
#######. #
#######$ #
#######  #
### ### .#
### # ## #
# $@$   .#
# .  $   #
##########