##########
#  ## ####
# $$  .. #
#  #     #
#. #######
# $#######
#@ #######
#.$     ##
#  #  ####
##########