##########
######@###
######$  #
#####  $ #
#####  # #
##### $$.#
#### .   #
##### .. #
#####    #
##########