##########
#.   $ ###
#.   $@###
# # ######
#. ###   #
#  ###   #
#$ #     #
#  #   $.#
#     ####
##########