##########
#   ######
# . ######
#  #######
#  .######
# $$######
#.  ######
# $ .  $@#
#   #   ##
##########