##########
##### .@ #
#### $ $ #
#### ..$ #
#######$.#
#######  #
######## #
##########
##########
##########