##########
##########
########.#
######## #
###### . #
#####. $ #
#####  $$#
#######$@#
####### .#
##########