##########
#  .#    #
# $    $ #
# .## @ ##
# ### $###
# ###. ###
#  ## ####
# $##  ###
#    .  ##
##########