##########
#   #### #
#@$ ###  #
#  ##### #
#.$ #  # #
# $ .   .#
#  #.  $ #
##########
##########
##########