##########
##########
##########
######## #
####### .#
##### #$ #
##### $. #
#### $.$ #
####@ .  #
##########