##########
##########
##########
##########
#####  ###
##### . ##
## ## $###
# $  $.$ #
#  . .  @#
##########