##########
#######@##
###### $ #
######  ##
#  #### ##
#.  .$.. #
#  #     #
# # ##$$##
#        #
##########