##########
##.   ####
#  $$#####
# $$ #####
#    #####
# # @#####
#  # #####
# .  .####
#.    ####
##########