##########
##########
## #######
#..  #####
# .$$# ###
# #$ . $@#
#      ###
#  # #####
# ########
##########