##########
#  . . $@#
#   # $###
#  # .$ ##
# #     ##
# .     ##
# $ ######
#   ######
##########
##########