##########
#  .     #
# .      #
# ####   #
# #####  #
#   . $$ #
# $$ #   #
#@.#######
# ########
##########