##########
##########
##########
##########
###    . #
###.   $$#
###@$ $  #
####### .#
#######. #
##########