##########
##########
##########
##########
######.  #
###@$ .$ #
#### $ $ #
####   .##
##### . ##
##########