##########
##########
##########
##########
# .@. ####
# $$$ ####
# # $#####
#.#   ####
#   .    #
##########