##########
#@ #######
# $#######
#. #######
#  # #####
#.$ .#####
# $.  ####
### $ ####
###  #####
##########