##########
## #######
#        #
#    .$  #
#  ####. #
#.#####$ #
#@#### . #
#  $  $  #
# ##     #
##########