##########
#  . #####
#.$$ #####
#    #####
##   #####
## $######
### ######
#@$.######
#  .######
##########