##########
### .$ ###
# ##    ##
# .$.# ###
# $  # ###
#  #######
# . ######
# $#######
# @  #####
##########