##########
#  .. $ @#
# $ $.  ##
# $ ######
#  #######
#.########
# ########
# ########
##########
##########