##########
#.$ ######
#    #####
# #  #####
##  ####@#
##  ##  $#
# .  # $ #
# $###   #
#   .   .#
##########