##########
#       .#
# $ $  . #
######## #
#######  #
###### # #
####@$ . #
#####. $ #
####     #
##########