##########
##########
######   #
######.$ #
#######$.#
#######  #
######   #
###@$  $.#
### #  . #
##########