##########
##########
##########
##.   ####
#  #  ####
# . #  ###
# $$ $ ###
#@. $ ####
# .#######
##########