##########
##   #####
#  @     #
#    ##$ #
#  ## #  #
# #  .   #
# $ #    #
# $$.#####
# . .#####
##########