##########
#    .####
# $$$#####
# # @#####
#  # #####
#  #  ####
# #..#####
# $ . ####
#       ##
##########