##########
##########
##########
##########
##########
#####  ###
##### $  #
#### $.$ #
###@$. ..#
##########