##########
##########
##@.######
##$$######
##  ######
##. ######
# $..##  #
#  $# #  #
#        #
##########