##########
#####.  .#
##### $  #
#######  #
#### @## #
#### . # #
####  .$ #
#### $##$#
####     #
##########