##########
#####    #
#####.  .#
######.$ #
#######  #
#######$ #
#####@$  #
###### $.#
#######  #
##########