##########
#####.####
###   @ ##
###$ $ ###
### $#####
###. # # #
##  #    #
##  # .$ #
##.      #
##########