##########
# ########
# #  #   #
# $ .$ .##
#    #  ##
#.#### ###
# $ . $###
#    #@###
##########
##########