##########
#       ##
# $ $ .###
# ####  ##
# ###  ###
# ###   ##
# ##### ##
# ####   #
#.$.@$  .#
##########