##########
###   ####
# $ $ ####
# ##  ####
#.#  #####
#    #####
#     ## #
# @# $ $ #
#..  .   #
##########