##########
####    .#
#### $$$.#
#####    #
######## #
########.#
####### .#
#### $   #
####  @  #
##########