##########
# .  .   #
#$$ $  $.#
#.#####  #
# ######@#
##########
##########
##########
##########
##########