##########
# # ######
#  . $@###
#   #$####
# ### $ ##
# ##  $ ##
# ##   .##
# ### .  #
#    .   #
##########