##########
##       #
### $    #
#### . ###
#####  ###
####  ####
####$..###
###.$$####
### @ ####
##########