##########
# .    $@#
#  ## $ $#
#######  #
###### #.#
# ####  .#
# ###  ###
#   #$ ###
#  .    ##
##########