##########
#### $ . #
### .  $ #
###   #  #
########.#
######## #
#####@$  #
###### $ #
#####  . #
##########