##########
##########
######  ##
####   $ #
#### .$ ##
###### . #
#####@ $.#
######$. #
#####    #
##########