##########
#####.   #
#### $  .#
####   $ #
##  ### .#
#   ####.#
##$ #### #
# $      #
# @      #
##########