##########
##########
######## #
######## #
########.#
# ###### #
#@$.  .  #
# $ $ $  #
# ##### .#
##########