##########
##########
##########
##########
# ########
#  ###@###
#  #  $ .#
# $#$. $ #
# .   . ##
##########