##########
### .  ###
## $   ###
# $. . ###
#  $ # ###
###  #  ##
#####  ###
## # # ###
#.    $@##
##########