##########
##########
##########
##@ ######
# $#######
# . ######
#  $######
#..  $ # #
# $   .  #
##########