##########
# ########
# ########
#  #######
# $#######
#  ## ####
#.$$  $ ##
#..    .##
#@ #######
##########