##########
##########
##########
#### .####
####$ ####
#@$.  ####
# # . #  #
# ###  $ #
#  $    .#
##########