##########
##########
### ## ###
#@     ###
#. $   ###
# #    ###
# ######.#
# $ .$   #
# .    $ #
##########