##########
####  ## #
##       #
##  .  $ #
##. ###$ #
##  .##  #
### ## $ #
## $.##  #
##  @#####
##########