##########
##########
#### ##@##
##  $ .$##
##.$ $  .#
#  ####  #
## #### ##
##.# #  ##
#       ##
##########