##########
#.  . ####
#   ######
#   ##   #
#  ### .##
##$   $ ##
##  #  $@#
###### $ #
###### .##
##########