##########
#@  ######
#$$.######
# .$######
# . ##  ##
# $ #  ###
#. ##  ###
# ###  ###
#      ###
##########