##########
#    #####
# $$ #####
# .#.#####
#  #######
# ###@ .##
#  ###$ ##
# ###  $ #
#.       #
##########