##########
##########
##### ####
##### ####
##### ##.#
####@$ ..#
##### $$ #
### # #.$#
###      #
##########