##########
# .  @   #
# $ $. $ #
##$#######
#  #######
#  #######
#..#######
#   ######
#    #####
##########