##########
# # ######
#   ######
# ..$  $@#
# $$.  .##
#  #######
##########
##########
##########
##########