##########
###      #
## $$. # #
#  .$ $ ##
#   .# @##
#    #####
#.########
#  #######
#  #######
##########