##########
##########
##########
##########
###   ####
# $   $. #
#.$ # $.##
# ##  #  #
#. @     #
##########