##########
##########
#######@##
#####  $##
###### .##
###### . #
######$  #
##  $ .  #
###   $. #
##########