##########
# ########
# ####  ##
# .     ##
#   $#   #
#  #. # ##
# .@  . ##
#  $ $$ ##
####  # ##
##########