##########
#       .#
# ##.$$. #
#####$ $ #
##### .@##
##########
##########
##########
##########
##########