##########
##########
##########
##  ### ##
# ..   . #
## $  $  #
####### .#
#######$$#
#####   @#
##########