##########
###.  .. #
#### $$  #
######  .#
#######$ #
#######  #
# ###### #
# ######$#
#     @  #
##########