##########
### @#####
###$ #####
#.  . ####
# $$. ####
# . $#####
# #  #####
#  #######
#  #######
##########