##########
####### ##
##### $.##
#####@$ ##
#  ##$ ###
#  $  .###
##.  . ###
#  ####  #
#        #
##########