##########
##########
##########
##########
##########
# ########
# @#    ##
# $$.. $ #
# . $  . #
##########