##########
##########
##########
#  #######
# $#######
#  .######
#.$.#### #
#.$$##   #
#@       #
##########