##########
## . .  .#
##  $. $ #
#### $$ ##
##### @###
##########
##########
##########
##########
##########