##########
#        #
# .@$ $$ #
######  ##
######   #
######   #
#######.##
### $  . #
###    .##
##########