##########
##########
##########
##########
##########
#    . ###
#   $$$###
# .##  $ #
# .   . @#
##########