##########
##########
#  #######
# ########
# ########
#  #######
#.$$   $@#
#  . $.###
#   . ####
##########