##########
##########
###   ####
###  $####
###.. ####
### . ####
####  ####
### $$$@##
###   .  #
##########