##########
#  ##.####
#@$   . ##
# $ $ $  #
# .##. ###
# ########
# ########
#   ######
#    #####
##########