##########
##########
##########
##########
#@.## . ##
# $$  $$ #
#   ..   #
##### ####
##### ####
##########