##########
##########
#  #######
#        #
#   # . $#
#  ####. #
# # ###. #
# $ $  $.#
# #   @  #
##########