##########
##########
#@########
#$########
#  #######
# .#######
#.    .  #
# $  $ $ #
#. ##### #
##########