##########
#@       #
#  # $.###
# #  #####
#. $.#####
#  $ #####
# $#######
#. #######
##########
##########