##########
##########
##########
##########
##########
#@$.   ###
# $  $  ##
###$.# ###
#      ..#
##########