##########
##########
# @ ######
##$#######
# .#######
#$ #######
#   $  ###
#  #. $ ##
#.    . ##
##########