##########
######## #
#######  #
#######. #
##### #  #
## $   . #
##@# .$. #
##### $$ #
######   #
##########