##########
#   @   .#
#   #. $ #
# $#####.#
#  ## .  #
# $$     #
##       #
##########
##########
##########