##########
#       .#
# $. #   #
## $###  #
##  ###  #
#..$###$ #
#      @ #
# # #    #
##########
##########