##########
##########
######## #
#######  #
####### .#
######## #
####### .#
# $@$  $$#
#.      .#
##########