##########
## #######
#.. ## ###
# $ .    #
# $  $ # #
# .##### #
# #####  #
#$###    #
#@ ###   #
##########