##########
##########
##########
##########
##########
#  #######
#  $ # .##
# # $ $$ #
#.# .@.  #
##########