##########
#. #######
#   ######
# . ######
## #######
# $#######
#  ##  ###
# $    $@#
#..  $ ###
##########