##########
#   .  $ #
#   #    #
# ########
# #   ####
#  # #####
# $$ #####
# .$. ####
# @.  ####
##########