##########
##########
#  #######
# $ # ####
# .  .$@##
# $ $ ####
#  .######
#  #######
# .#######
##########