##########
##########
##########
### ######
### ######
##  ######
##.$ ### #
#.   $ $ #
# $. . @ #
##########