##########
#  #######
# .  ##  #
#  .###$ #
#  ####@ #
#      $.#
## ##    #
## $ ### #
#  .   $ #
##########