##########
##########
#####@## #
#####$   #
#### .$$ #
#####  ###
####   ###
## .  $###
#. .   ###
##########