##########
#      ###
#. $.#####
##$ .#####
##   #####
### $#####
###. #####
## $######
## @######
##########