##########
#   .  . #
#  #     #
# $ ### .#
#  ####  #
# $ ## $ #
#  ###   #
##. ###$ #
#    @  ##
##########