##########
##########
##########
###   .$ #
###  # $ #
#######  #
####### .#
#### .$  #
##@$    .#
##########