##########
##### #  #
# . . $..#
## $   $ #
#######  #
#######$ #
#######  #
######## #
########@#
##########