##########
##########
# ## #####
# $ @ . ##
# ## $$ ##
# ####  ##
# ### $###
#   # . ##
#   . .  #
##########