##########
##   @   #
##   . $ #
# .##    #
# .$ . ###
##  $ ####
####$ ####
####  ####
##### ####
##########