##########
#   .    #
#  #   . #
#### $#  #
#### .####
####   ###
#####  .##
####@$$$ #
####     #
##########