##########
##   #   #
#  $ $ $ #
##       #
## $##   #
###. ## ##
## .### ##
##. .   ##
####  @ ##
##########