##########
# ..  $@##
#  .$ ####
## $$ ####
## #  ####
###   ####
###.   ###
####  ####
####  ####
##########