##########
#@ #######
#$$#######
#  ###  ##
#    .$  #
#. .$ . ##
# ####   #
# ##### ##
#   ### ##
##########