##########
#   .  ###
# #@$.$ ##
####$$ ..#
####     #
##########
##########
##########
##########
##########