##########
####### @#
#######$$#
#######. #
#######. #
####### .#
#######$ #
######.$ #
#######  #
##########