##########
#  #######
# $#######
#  #@# ###
#   $ $ .#
#  #.#   #
# ########
#.  ######
# $. #####
##########