##########
#.   #####
#   ######
##$  #####
##   #####
##$ ######
## .##.# #
## $   # #
###@$   .#
##########