##########
#  .   ###
# #    ###
# ##  .###
#  #   ###
# $ $# ###
## . #####
# $$######
# .@ #####
##########