##########
#####@##.#
#### $## #
####  $. #
#### $   #
#######  #
#######. #
## ### $ #
##    .  #
##########