##########
# . ###.##
#    ## ##
# $.  $. #
#    #  ##
######   #
######$ ##
###### $##
####### @#
##########