##########
#   ######
#.  ######
#. #######
# $##@####
# .  $ $ #
# $#     #
#  ####.##
# ####  ##
##########