##########
# @  . ###
#  # $ ###
## ##$$ ##
##### . ##
##### $###
#####  ###
#####..###
##########
##########