##########
#@########
# ###  ###
# ###   ##
#.$   .###
# # $ .###
# ### ####
#  $   $ #
#  #   . #
##########