##########
##########
##########
##########
#@########
#. #######
# $ ######
#$  $ .. #
#   . $  #
##########