##########
#        #
##. $ . @#
##..######
###$ #####
# #  #####
#    #####
# $$######
#   ######
##########