##########
# @     ##
#$$. $ ###
#  #######
#  #######
# ########
# ########
#.. $ ####
#.    ####
##########