##########
######   #
####  $$ #
####$ .  #
#### .#  #
##@$  #  #
### . ## #
####### .#
######## #
##########