##########
# .   ####
#  $$.####
# ##@$####
# ### ####
# ##  ####
# #  . ###
#  .$  ###
#    #####
##########