##########
# ##  ####
# $ . ####
# $$$.####
# #  @ ###
# ###. ###
# ## .####
# ##  ####
#     ####
##########